program_id,sample_id,run_id,iterations_count,engine_overhead_time_ns,execution_loop_time_ns,total_time_ns,mem_allocs_count,mem_allocs_bytes
1,1,1,24074,17862,29302,47164,43,42573
1,1,2,26506,15238,30531,45769,43,42547
1,1,3,24432,16089,31039,47128,43,42569
1,1,4,27267,15010,31775,46785,43,42540
1,1,5,25798,15988,27997,43985,43,42554
1,1,6,24312,15472,31613,47085,43,42571
1,1,7,24529,15707,40153,55860,43,42569
1,1,8,26272,15394,29759,45153,43,42550
1,1,9,26492,14858,28777,43635,43,42548
1,1,10,26032,15717,29509,45226,43,42552
1,1,11,26034,15592,32122,47714,43,42553
1,1,12,25506,15842,26438,42280,43,42557
1,1,13,29409,12590,29671,42261,43,42522
1,1,14,25558,15530,27620,43150,43,42557
1,1,15,27807,14782,29309,44091,43,42536
1,1,16,28046,14579,29391,43970,43,42534
1,1,17,24392,16897,34475,51372,43,42570
1,1,18,22522,17652,29226,46878,43,42529
1,1,19,26634,14734,28872,43606,43,42546
1,1,20,27093,14202,29627,43829,43,42542
1,1,21,27110,14524,29127,43651,43,42542
1,1,22,27331,14300,29765,44065,43,42540
1,1,23,24619,14801,30495,45296,43,42567
1,1,24,25447,17692,27718,45410,43,42558
1,1,25,26448,15486,28921,44407,43,42548
1,1,26,23934,17094,30392,47486,43,42575
1,1,27,24904,16498,30469,46967,43,42563
1,1,28,27385,14471,29834,44305,43,42540
1,1,29,27330,14886,28335,43221,43,42540
1,1,30,27409,14580,27854,42434,43,42539
1,1,31,30195,12603,24803,37406,43,42576
1,1,32,26098,15053,29495,44548,43,42551
1,1,33,26124,14935,28247,43182,43,42551
1,1,34,26738,14062,31033,45095,43,42545
1,1,35,25444,15211,36560,51771,43,42559
1,1,36,24415,16678,32638,49316,43,42570
1,1,37,30168,14465,21485,35950,43,42576
1,1,38,27045,13323,30660,43983,43,42543
1,1,39,28652,14263,30570,44833,43,42529
1,1,40,25945,14329,29902,44231,43,42554
1,1,41,26630,13167,31485,44652,43,42547
1,1,42,25540,15896,29204,45100,43,42557
1,1,43,26128,14500,30916,45416,43,42551
1,1,44,24283,15831,31966,47797,43,42571
1,1,45,25867,15264,28545,43809,43,42554
1,1,46,26986,14902,28685,43587,43,42543
1,1,47,30733,12343,25357,37700,43,42571
1,1,48,27171,14981,28255,43236,43,42541
1,1,49,25446,16994,26821,43815,43,42559
1,1,50,30957,12131,29172,41303,43,42569
2,1,1,19113,21105,35468,56573,44,59090
2,1,2,16903,17926,57956,75882,44,59059
2,1,3,15080,23644,54997,78641,44,59088
2,1,4,18507,18875,48257,67132,44,59058
2,1,5,17742,21113,47973,69086,44,59046
2,1,6,16984,21996,46104,68100,44,59057
2,1,7,17556,19235,47887,67122,44,59048
2,1,8,21307,18511,36895,55406,44,59060
2,1,9,18561,18405,49881,68286,44,59057
2,1,10,21138,17027,43798,60825,44,59063
2,1,11,16742,20626,46333,66959,44,59060
2,1,12,18560,19082,47434,66516,44,59057
2,1,13,18160,19619,48224,67843,44,59042
2,1,14,19021,19124,46173,65297,44,59091
2,1,15,17629,20614,48290,68904,44,59048
2,1,16,18177,20361,50279,70640,44,59041
2,1,17,17853,20294,45199,65493,44,59044
2,1,18,17676,20900,45404,66304,44,59047
2,1,19,18566,18959,49959,68918,44,59057
2,1,20,15889,24026,50312,74338,44,59075
2,1,21,21500,16835,52051,68886,44,59059
2,1,22,20980,18620,37057,55677,44,59065
2,1,23,21055,17851,37975,55826,44,59063
2,1,24,19576,17565,50036,67601,44,59083
2,1,25,18723,18996,47401,66397,44,59095
2,1,26,18316,20863,48927,69790,44,59040
2,1,27,15604,23778,57014,80792,44,59080
2,1,28,13974,26770,50360,77130,44,59046
2,1,29,17611,22133,43563,65696,44,59048
2,1,30,17151,19458,47911,67369,44,59054
2,1,31,21277,19382,35261,54643,44,59060
2,1,32,19510,17359,48477,65836,44,59083
2,1,33,17778,19280,46473,65753,44,59046
2,1,34,18470,21285,45799,67084,44,59057
2,1,35,17763,20698,45841,66539,44,59046
2,1,36,21463,17863,39100,56963,44,59058
2,1,37,17950,20577,45906,66483,44,59044
2,1,38,13286,23338,58185,81523,44,59058
2,1,39,17215,23155,47236,70391,44,59054
2,1,40,18278,19370,45536,64906,44,59040
2,1,41,17938,19673,43612,63285,44,59044
2,1,42,20350,17669,40997,58666,44,59071
2,1,43,18230,20711,45610,66321,44,59040
2,1,44,18018,19898,47397,67295,44,59043
2,1,45,17690,18759,48617,67376,44,59047
2,1,46,16851,19717,52749,72466,44,59059
2,1,47,22423,17995,36921,54916,44,59048
2,1,48,18614,18479,47884,66363,44,59056
2,1,49,18104,19758,47164,66922,44,59041
2,1,50,18210,20104,47763,67867,44,59040
3,1,1,10000,38600,113052,151652,47,82268
3,1,2,10000,39018,112630,151648,47,82261
3,1,3,7399,38812,130929,169741,47,82292
3,1,4,10000,39054,112858,151912,47,82251
3,1,5,8227,44794,141860,186654,47,82257
3,1,6,9124,43350,117222,160572,47,82246
3,1,7,10000,39089,112800,151889,47,82260
3,1,8,7521,38623,123761,162384,47,82279
3,1,9,7356,38252,120299,158551,47,82266
3,1,10,6506,38828,126904,165732,47,82253
3,1,11,7660,37659,117564,155223,47,82280
3,1,12,9489,39212,115105,154317,47,82277
3,1,13,7677,38483,103870,142353,47,82273
3,1,14,9928,33605,110116,143721,47,82255
3,1,15,10000,39590,120801,160391,47,82257
3,1,16,10000,44474,111119,155593,47,82273
3,1,17,7442,38155,121255,159410,47,82262
3,1,18,8486,38284,108550,146834,47,82233
3,1,19,8221,33942,102656,136598,47,82256
3,1,20,10000,32900,101206,134106,47,82239
3,1,21,8716,33958,103516,137474,47,82259
3,1,22,9148,33092,103243,136335,47,82248
3,1,23,10000,33933,119074,153007,47,82279
3,1,24,6268,39271,124133,163404,47,82253
3,1,25,9429,38997,117008,156005,47,82262
3,1,26,10000,37875,115155,153030,47,82254
3,1,27,7621,44483,137880,182363,47,82264
3,1,28,7627,39435,117609,157044,47,82302
3,1,29,10000,38761,116697,155458,47,82255
3,1,30,7651,39090,111569,150659,47,82254
3,1,31,10000,34155,99119,133274,47,82253
3,1,32,8211,37849,115161,153010,47,82235
3,1,33,7921,39173,126023,165196,47,82270
3,1,34,8883,39579,120135,159714,47,82275
3,1,35,7666,38348,113716,152064,47,82277
3,1,36,10000,38263,112985,151248,47,82252
3,1,37,7684,39370,127105,166475,47,82251
3,1,38,7092,39703,132704,172407,47,82257
3,1,39,10000,37748,151190,188938,47,82275
3,1,40,7216,39350,126461,165811,47,82289
3,1,41,9894,38878,114331,153209,47,82257
3,1,42,7933,38053,139011,177064,47,82247
3,1,43,6627,37786,125819,163605,47,82252
3,1,44,7692,38441,120574,159015,47,82269
3,1,45,10000,33987,102998,136985,47,82266
3,1,46,10000,39045,109849,148894,47,82245
3,1,47,10000,33061,106292,139353,47,82275
3,1,48,6110,45415,133196,178611,47,82275
3,1,49,8462,34915,125152,160067,47,82254
3,1,50,10000,40009,113123,153132,47,82250
4,1,1,10000,32133,85878,118011,45,61617
4,1,2,10000,33212,80757,113969,45,61612
4,1,3,10000,32858,89360,122218,45,61621
4,1,4,10000,32957,85574,118531,45,61613
4,1,5,10000,33120,90202,123322,45,61613
4,1,6,10000,27401,77064,104465,45,61609
4,1,7,10000,28257,81037,109294,45,61619
4,1,8,10000,30267,77909,108176,45,61609
4,1,9,10000,31978,93543,125521,45,61618
4,1,10,10000,33041,86009,119050,45,61620
4,1,11,10000,32847,95221,128068,45,61604
4,1,12,10000,34134,85347,119481,45,61622
4,1,13,10000,32835,88828,121663,45,61620
4,1,14,10000,33705,85586,119291,45,61619
4,1,15,10000,32542,90069,122611,45,61613
4,1,16,8766,33460,89182,122642,45,61619
4,1,17,10000,27747,77015,104762,45,61615
4,1,18,10000,27758,79777,107535,45,61613
4,1,19,10000,32583,88101,120684,45,61617
4,1,20,10000,37610,97293,134903,45,61612
4,1,21,6970,38408,107900,146308,45,61615
4,1,22,8780,32396,87706,120102,45,61619
4,1,23,10000,32674,89110,121784,45,61621
4,1,24,10000,27627,75873,103500,45,61621
4,1,25,10000,31394,85930,117324,45,61619
4,1,26,10000,32890,88137,121027,45,61616
4,1,27,10000,32723,87884,120607,45,61619
4,1,28,10000,32965,85780,118745,45,61615
4,1,29,10000,32673,84828,117501,45,61614
4,1,30,10000,32784,88044,120828,45,61615
4,1,31,10000,35905,90207,126112,45,61618
4,1,32,10000,36285,88328,124613,45,61604
4,1,33,8349,36459,89311,125770,45,61609
4,1,34,10000,27449,79673,107122,45,61614
4,1,35,10000,28268,77110,105378,45,61621
4,1,36,10000,32368,87317,119685,45,61616
4,1,37,9900,33028,86776,119804,45,61615
4,1,38,10000,30871,77344,108215,45,61613
4,1,39,9736,34078,127592,161670,45,61639
4,1,40,5924,77103,123390,200493,45,61649
4,1,41,10000,31666,91938,123604,45,61628
4,1,42,7410,44343,133782,178125,45,61663
4,1,43,10000,36182,94261,130443,45,61630
4,1,44,10000,26828,74754,101582,45,61616
4,1,45,10000,27505,74689,102194,45,61605
4,1,46,10000,30538,85330,115868,45,61601
4,1,47,10000,32553,85821,118374,45,61610
4,1,48,10110,32672,89436,122108,45,61609
4,1,49,10000,33171,86922,120093,45,61614
4,1,50,10000,32056,91052,123108,45,61605
5,1,1,6780,59107,144813,203920,45,60995
5,1,2,9117,63858,111650,175508,45,60952
5,1,3,7114,58847,110108,168955,45,61053
5,1,4,7110,56424,93081,149505,45,60998
5,1,5,10000,49759,87514,137273,45,60818
5,1,6,10000,49067,90500,139567,45,61024
5,1,7,10000,48787,102784,151571,45,60999
5,1,8,7621,58325,105431,163756,45,60997
5,1,9,10000,56748,97879,154627,45,60934
5,1,10,9462,58773,102466,161239,45,61016
5,1,11,9458,54422,84546,138968,45,60992
5,1,12,8422,61766,137285,199051,45,61082
5,1,13,6813,65628,106742,172370,45,61051
5,1,14,10000,59459,99290,158749,45,60918
5,1,15,8731,58797,105257,164054,45,60979
5,1,16,8202,56785,105310,162095,45,60982
5,1,17,10000,56615,99906,156521,45,60976
5,1,18,10000,58546,101505,160051,45,60934
5,1,19,9871,58241,111844,170085,45,60955
5,1,20,6614,58571,103844,162415,45,61015
5,1,21,9870,56328,121385,177713,45,60955
5,1,22,7204,59623,84059,143682,45,61037
5,1,23,10000,49170,104630,153800,45,60982
5,1,24,9164,55968,107714,163682,45,61067
5,1,25,10000,55213,82432,137645,45,61024
5,1,26,10000,52359,105933,158292,45,60953
5,1,27,10000,57261,109302,166563,45,60934
5,1,28,8518,59276,101406,160682,45,61002
5,1,29,10000,50770,88763,139533,45,61024
5,1,30,6976,57006,110308,167314,45,60988
5,1,31,7218,58687,107771,166458,45,61022
5,1,32,10000,58906,117932,176838,45,60970
5,1,33,7662,71391,116347,187738,45,61044
5,1,34,10000,61873,96142,158015,45,60918
5,1,35,10000,58469,86734,145203,45,60973
5,1,36,6400,49125,107581,156706,45,60985
5,1,37,10000,58914,102630,161544,45,61019
5,1,38,9090,59328,129021,188349,45,60991
5,1,39,10000,57445,102773,160218,45,60970
5,1,40,9880,58218,102624,160842,45,60983
5,1,41,10000,57677,109117,166794,45,60948
5,1,42,7902,64560,109352,173912,45,61021
5,1,43,7386,62172,104261,166433,45,61001
5,1,44,7940,56861,111852,168713,45,61015
5,1,45,7723,53914,95176,149090,45,60962
5,1,46,10000,52098,90838,142936,45,60985
5,1,47,10000,51542,89610,141152,45,60866
5,1,48,10000,52964,83532,136496,45,60922
5,1,49,7424,51962,90889,142851,45,61026
5,1,50,9474,51637,85059,136696,45,60919
6,1,1,7420,55293,124488,179781,46,64607
6,1,2,5950,66833,143520,210353,46,64595
6,1,3,7929,62436,122949,185385,46,64591
6,1,4,6990,54909,124737,179646,46,64583
6,1,5,10000,56455,121550,178005,46,64595
6,1,6,6602,59870,125968,185838,46,64572
6,1,7,8820,54793,122167,176960,46,64589
6,1,8,6802,57249,126176,183425,46,64586
6,1,9,5954,56108,131476,187584,46,64598
6,1,10,10000,55868,119034,174902,46,64599
6,1,11,6596,56093,127928,184021,46,64571
6,1,12,7147,61408,124364,185772,46,64575
6,1,13,8481,52037,128527,180564,46,64574
6,1,14,5911,67650,122697,190347,46,64593
6,1,15,7904,49371,105916,155287,46,64590
6,1,16,7460,49291,120947,170238,46,64605
6,1,17,5924,55796,131298,187094,46,64600
6,1,18,8756,56540,127218,183758,46,64587
6,1,19,5970,56285,129182,185467,46,64597
6,1,20,7440,56727,110022,166749,46,64606
6,1,21,10000,48841,116794,165635,46,64595
6,1,22,7936,55437,128412,183849,46,64588
6,1,23,4916,65050,157071,222121,46,64578
6,1,24,6765,70099,149169,219268,46,64588
6,1,25,10000,63992,98908,162900,46,64599
6,1,26,7350,48694,111791,160485,46,64609
6,1,27,6784,56270,128234,184504,46,64587
6,1,28,8790,58365,126164,184529,46,64586
6,1,29,5794,56826,132390,189216,46,64604
6,1,30,5920,57978,126080,184058,46,64599
6,1,31,6606,55635,129355,184990,46,64573
6,1,32,7658,56273,139764,196037,46,64598
6,1,33,7236,63767,131060,194827,46,64615
6,1,34,5946,54861,131112,185973,46,64596
6,1,35,7977,58427,133231,191658,46,64587
6,1,36,8481,59060,121277,180337,46,64576
6,1,37,9889,57776,122231,180007,46,64598
6,1,38,6499,54761,126833,181594,46,64575
6,1,39,7186,57560,137317,194877,46,64616
6,1,40,9412,55125,110792,165917,46,64610
6,1,41,7207,52951,145975,198926,46,64615
6,1,42,6366,60420,115265,175685,46,64580
6,1,43,6973,60210,147570,207780,46,64583
6,1,44,5523,63158,129621,192779,46,64577
6,1,45,5950,57338,126212,183550,46,64595
6,1,46,6769,56530,128851,185381,46,64590
6,1,47,6931,56418,126611,183029,46,64581
6,1,48,10000,57600,105361,162961,46,64595
6,1,49,9502,50971,127418,178389,46,64611
6,1,50,7599,56955,125633,182588,46,64604
7,1,1,10000,27976,109837,137813,47,88519
7,1,2,8815,31946,111226,143172,47,88515
7,1,3,9115,31520,105041,136561,47,88498
7,1,4,10000,31192,106826,138018,47,88517
7,1,5,10000,29392,102985,132377,47,88515
7,1,6,10000,28694,106046,134740,47,88515
7,1,7,7928,30521,104716,135237,47,88518
7,1,8,8464,28757,90567,119324,47,88495
7,1,9,10000,26151,92856,119007,47,88509
7,1,10,9925,25759,98584,124343,47,88516
7,1,11,10000,29732,116399,146131,47,88518
7,1,12,10000,30548,100510,131058,47,88512
7,1,13,9900,30619,123059,153678,47,88520
7,1,14,10000,33927,89428,123355,47,88521
7,1,15,9896,25104,97593,122697,47,88519
7,1,16,8559,30242,107121,137363,47,88494
7,1,17,8133,30823,101673,132496,47,88507
7,1,18,9495,26440,87288,113728,47,88532
7,1,19,10000,26834,107395,134229,47,88517
7,1,20,10000,30402,103017,133419,47,88519
7,1,21,8510,30511,100429,130940,47,88496
7,1,22,10000,31323,90193,121516,47,88523
7,1,23,10000,25367,88308,113675,47,88520
7,1,24,7611,30836,104443,135279,47,88527
7,1,25,10000,30116,98128,128244,47,88524
7,1,26,10000,29721,108364,138085,47,88516
7,1,27,8474,31234,104700,135934,47,88495
7,1,28,6966,31045,115739,146784,47,88509
7,1,29,8498,30947,101553,132500,47,88499
7,1,30,9831,30424,100504,130928,47,88512
7,1,31,8476,29791,105485,135276,47,88497
7,1,32,8475,30598,111609,142207,47,88491
7,1,33,8132,31917,118789,150706,47,88509
7,1,34,9201,30257,102402,132659,47,88499
7,1,35,9646,29330,107101,136431,47,88530
7,1,36,10000,30973,100083,131056,47,88519
7,1,37,10000,30429,116864,147293,47,88529
7,1,38,10000,36538,114694,151232,47,88519
7,1,39,9142,33672,101847,135519,47,88498
7,1,40,10000,24713,95460,120173,47,88523
7,1,41,10000,29052,102877,131929,47,88511
7,1,42,10000,29715,102750,132465,47,88519
7,1,43,10000,24600,88151,112751,47,88510
7,1,44,10000,25559,86520,112079,47,88510
7,1,45,7701,28970,104803,133773,47,88518
7,1,46,10000,31202,102780,133982,47,88513
7,1,47,10000,29723,108561,138284,47,88517
7,1,48,10000,30912,110681,141593,47,88511
7,1,49,10166,27692,91347,119039,47,88515
7,1,50,10000,25740,88176,113916,47,88510
8,1,1,9548,40719,93689,134408,44,55871
8,1,2,9121,44992,107031,152023,44,55826
8,1,3,7695,42816,94054,136870,44,55854
8,1,4,8154,41632,98305,139937,44,55856
8,1,5,10000,43365,94718,138083,44,55854
8,1,6,10000,42781,97198,139979,44,55871
8,1,7,9963,43071,94723,137794,44,55856
8,1,8,9946,43097,119386,162483,44,55883
8,1,9,7177,46675,109922,156597,44,55881
8,1,10,8796,45409,91550,136959,44,55861
8,1,11,10000,41890,91686,133576,44,55849
8,1,12,5074,66944,173515,240459,44,55853
8,1,13,9172,51533,98983,150516,44,55847
8,1,14,8853,41287,99660,140947,44,55851
8,1,15,8510,43164,111152,154316,44,55837
8,1,16,10000,42212,94609,136821,44,55844
8,1,17,9934,42959,92102,135061,44,55863
8,1,18,10000,43554,100813,144367,44,55855
8,1,19,10000,45061,96093,141154,44,55865
8,1,20,7966,41840,97989,139829,44,55854
8,1,21,10000,43831,95271,139102,44,55857
8,1,22,7900,48109,92620,140729,44,55848
8,1,23,10000,41960,91371,133331,44,55853
8,1,24,8479,43538,83524,127062,44,55835
8,1,25,10000,37038,90385,127423,44,55860
8,1,26,10000,44172,91802,135974,44,55852
8,1,27,10000,42749,93169,135918,44,55855
8,1,28,8169,42633,99589,142222,44,55862
8,1,29,8964,42140,97670,139810,44,55855
8,1,30,7957,51477,472101,523578,44,55853
8,1,31,10000,44323,88015,132338,44,55845
8,1,32,10000,46723,105525,152248,44,55850
8,1,33,7424,47825,152729,200554,44,55883
8,1,34,10000,49043,87433,136476,44,55835
8,1,35,9158,41580,95443,137023,44,55828
8,1,36,10000,40730,95137,135867,44,55840
8,1,37,10000,41541,101588,143129,44,55856
8,1,38,10000,41226,91913,133139,44,55859
8,1,39,7452,42454,106678,149132,44,55859
8,1,40,7629,46729,109335,156064,44,55868
8,1,41,7854,54559,114161,168720,44,55872
8,1,42,8197,40974,95863,136837,44,55853
8,1,43,9076,70525,107943,178468,44,55840
8,1,44,6924,48714,129012,177726,44,55862
8,1,45,10000,44292,93258,137550,44,55855
8,1,46,7694,43393,95846,139239,44,55861
8,1,47,10000,42062,100069,142131,44,55851
8,1,48,10000,42465,90174,132639,44,55851
8,1,49,10000,42075,77878,119953,44,55838
8,1,50,10000,36380,83139,119519,44,55848
9,1,1,9710,40230,88118,128348,44,46524
9,1,2,10000,38217,94657,132874,44,46518
9,1,3,8592,43637,95567,139204,44,46491
9,1,4,10000,43761,90145,133906,44,46516
9,1,5,10000,43220,93116,136336,44,46517
9,1,6,10000,42023,76187,118210,44,46516
9,1,7,8845,37651,88733,126384,44,46504
9,1,8,10000,43470,81186,124656,44,46517
9,1,9,10000,37378,83755,121133,44,46516
9,1,10,10000,49577,95465,145042,44,46517
9,1,11,8397,44792,93178,137970,44,46496
9,1,12,8346,43645,94909,138554,44,46497
9,1,13,9814,43942,79371,123313,44,46520
9,1,14,10000,36700,87967,124667,44,46517
9,1,15,9504,43506,94489,137995,44,46530
9,1,16,8768,42832,92655,135487,44,46508
9,1,17,8515,43675,92575,136250,44,46493
9,1,18,9511,43966,90819,134785,44,46530
9,1,19,10000,44004,89710,133714,44,46516
9,1,20,10000,44378,92990,137368,44,46516
9,1,21,10000,43456,96123,139579,44,46516
9,1,22,10000,51187,98605,149792,44,46518
9,1,23,8488,49189,92521,141710,44,46495
9,1,24,10000,43982,86465,130447,44,46516
9,1,25,8552,44566,97328,141894,44,46493
9,1,26,10000,41258,77756,119014,44,46516
9,1,27,10000,37646,81063,118709,44,46517
9,1,28,10000,37633,92144,129777,44,46517
9,1,29,10000,42917,102300,145217,44,46517
9,1,30,10000,47144,93543,140687,44,46518
9,1,31,10000,50676,127277,177953,44,46518
9,1,32,10000,37231,87014,124245,44,46517
9,1,33,10000,49322,82665,131987,44,46517
9,1,34,10000,46763,80452,127215,44,46516
9,1,35,9680,58157,64557,122714,44,46525
9,1,36,10000,38722,85790,124512,44,46515
9,1,37,10000,40829,92303,133132,44,46517
9,1,38,8473,39142,153166,192308,44,46497
9,1,39,10000,33214,85404,118618,44,46516
9,1,40,8228,41420,132462,173882,44,46502
9,1,41,10000,40340,117954,158294,44,46516
9,1,42,7458,52348,101032,153380,44,46523
9,1,43,8467,43181,94984,138165,44,46495
9,1,44,8456,45360,94790,140150,44,46496
9,1,45,7911,43476,95414,138890,44,46510
9,1,46,7928,44967,94558,139525,44,46509
9,1,47,6878,45128,133037,178165,44,46501
9,1,48,10000,45128,91715,136843,44,46516
9,1,49,10000,44054,96821,140875,44,46517
9,1,50,7428,44666,98169,142835,44,46525
10,1,1,14509,23297,54113,77410,44,48068
10,1,2,20094,18702,46326,65028,44,48082
10,1,3,17427,21532,44682,66214,44,48058
10,1,4,17422,24177,89753,113930,44,48065
10,1,5,18400,17651,47189,64840,44,48047
10,1,6,19124,19200,44124,63324,44,48096
10,1,7,19563,18571,48263,66834,44,48095
10,1,8,19821,18613,43756,62369,44,48084
10,1,9,17110,20031,49746,69777,44,48062
10,1,10,17673,22580,44156,66736,44,48056
10,1,11,17715,21729,42519,64248,44,48056
10,1,12,19816,18394,42157,60551,44,48083
10,1,13,16672,24655,42809,67464,44,48068
10,1,14,20616,20328,40234,60562,44,48077
10,1,15,18847,19830,43717,63547,44,48099
10,1,16,19437,18772,42497,61269,44,48088
10,1,17,19178,19030,41795,60825,44,48093
10,1,18,17956,21207,44898,66105,44,48050
10,1,19,19664,19669,42282,61951,44,48088
10,1,20,22496,15994,38224,54218,44,48050
10,1,21,18462,19497,42498,61995,44,48061
10,1,22,20018,19627,43119,62746,44,48087
10,1,23,19521,20073,41189,61262,44,48091
10,1,24,18684,20435,41654,62089,44,48102
10,1,25,19926,18451,44926,63377,44,48084
10,1,26,17100,21919,42222,64141,44,48063
10,1,27,20193,18791,49382,68173,44,48087
10,1,28,16910,22751,49932,72683,44,48066
10,1,29,18552,22048,47385,69433,44,48061
10,1,30,19812,19135,41410,60545,44,48082
10,1,31,19206,19985,42189,62174,44,48095
10,1,32,17354,21097,43885,64982,44,48058
10,1,33,18055,22434,38854,61288,44,48050
10,1,34,19808,18704,42258,60962,44,48080
10,1,35,19284,19664,43273,62937,44,48091
10,1,36,17737,19407,47221,66628,44,48056
10,1,37,17230,22006,46955,68961,44,48058
10,1,38,19656,20442,44237,64679,44,48084
10,1,39,19740,18412,43676,62088,44,48089
10,1,40,18838,21284,39598,60882,44,48100
10,1,41,18966,20015,40972,60987,44,48095
10,1,42,19364,19119,39661,58780,44,48088
10,1,43,19561,20578,40635,61213,44,48086
10,1,44,19214,19958,41393,61351,44,48092
10,1,45,19633,19984,42227,62211,44,48092
10,1,46,18684,20041,42130,62171,44,48101
10,1,47,20038,21469,35396,56865,44,48083
10,1,48,17841,20007,41744,61751,44,48055
10,1,49,19850,19676,41233,60909,44,48081
10,1,50,19303,19507,43025,62532,44,48092
11,1,1,10000,34390,67808,102198,45,53152
11,1,2,10000,34141,77015,111156,45,53164
11,1,3,10000,35360,73161,108521,45,53158
11,1,4,10000,35767,74615,110382,45,53164
11,1,5,10000,35939,69363,105302,45,53162
11,1,6,10000,35679,76616,112295,45,53160
11,1,7,10000,38459,74530,112989,45,53163
11,1,8,10000,36718,74798,111516,45,53166
11,1,9,10000,35142,75596,110738,45,53168
11,1,10,10000,35238,76840,112078,45,53164
11,1,11,10000,35242,72163,107405,45,53155
11,1,12,10000,35321,74600,109921,45,53160
11,1,13,10000,35021,69962,104983,45,53152
11,1,14,10000,35119,71922,107041,45,53155
11,1,15,10000,35190,75912,111102,45,53171
11,1,16,10000,35381,73481,108862,45,53158
11,1,17,10990,34700,74442,109142,45,53131
11,1,18,10000,34734,76249,110983,45,53160
11,1,19,10000,34826,84965,119791,45,53164
11,1,20,10000,41770,82943,124713,45,53159
11,1,21,10000,37713,71715,109428,45,53162
11,1,22,12451,30503,74734,105237,45,53164
11,1,23,10000,35436,71434,106870,45,53159
11,1,24,9523,35548,71116,106664,45,53171
11,1,25,10000,34554,72782,107336,45,53156
11,1,26,12603,30998,69062,100060,45,53160
11,1,27,11394,34637,75167,109804,45,53149
11,1,28,10000,35916,77658,113574,45,53160
11,1,29,10000,36786,73667,110453,45,53161
11,1,30,9111,39903,77819,117722,45,53148
11,1,31,10000,39369,186103,225472,45,53178
11,1,32,6032,88876,164583,253459,45,53175
11,1,33,9236,59166,164950,224116,45,53186
11,1,34,7058,39747,193088,232835,45,53149
11,1,35,7502,80274,91490,171764,45,53164
11,1,36,3924,91243,197237,288480,45,53159
11,1,37,10000,37840,91021,128861,45,53162
11,1,38,10000,55981,81993,137974,45,53159
11,1,39,10000,44902,106625,151527,45,53161
11,1,40,10000,37595,91501,129096,45,53167
11,1,41,10000,37574,83927,121501,45,53155
11,1,42,10000,42234,77704,119938,45,53162
11,1,43,10000,37034,78322,115356,45,53160
11,1,44,6571,61246,202610,263856,45,53150
11,1,45,10000,34404,73628,108032,45,53157
11,1,46,10000,34769,76660,111429,45,53164
11,1,47,5454,41899,182079,223978,45,53152
11,1,48,5215,75695,166286,241981,45,53168
11,1,49,6660,107968,129822,237790,45,53169
11,1,50,4878,79437,194836,274273,45,53171
12,1,1,2998,138916,215985,354901,44,58077
12,1,2,5157,105793,239134,344927,44,58095
12,1,3,3472,158955,135361,294316,44,58102
12,1,4,3156,120211,238012,358223,44,58073
12,1,5,3636,107500,273498,380998,44,58114
12,1,6,4232,106327,291883,398210,44,58092
12,1,7,3332,184955,177956,362911,44,58100
12,1,8,3793,123600,152545,276145,44,58093
12,1,9,2926,117361,289705,407066,44,58087
12,1,10,3750,135541,220675,356216,44,58109
12,1,11,3157,129806,230293,360099,44,58079
12,1,12,4272,127162,308207,435369,44,58085
12,1,13,4123,120661,159281,279942,44,58067
12,1,14,2882,128720,269129,397849,44,58099
12,1,15,4928,89004,137261,226265,44,58085
12,1,16,7996,52100,127755,179855,44,58086
12,1,17,7941,54701,139188,193889,44,58087
12,1,18,6808,60197,126661,186858,44,58077
12,1,19,8002,51395,118013,169408,44,58083
12,1,20,7225,57681,120721,178402,44,58117
12,1,21,7951,52329,115971,168300,44,58088
12,1,22,4137,62278,269809,332087,44,58081
12,1,23,3634,114331,284612,398943,44,58108
12,1,24,4202,104278,187037,291315,44,58072
12,1,25,7491,53148,115829,168977,44,58102
12,1,26,7048,51767,141126,192893,44,58068
12,1,27,7208,62187,121994,184181,44,58114
12,1,28,6468,64103,163788,227891,44,58074
12,1,29,7970,53672,117402,171074,44,58087
12,1,30,9229,50245,116249,166494,44,58111
12,1,31,7502,55116,135812,190928,44,58107
12,1,32,7996,51016,118996,170012,44,58095
12,1,33,7498,50958,117544,168502,44,58113
12,1,34,7981,51733,127537,179270,44,58086
12,1,35,7944,57159,119091,176250,44,58101
12,1,36,7483,52222,124322,176544,44,58099
12,1,37,8191,53377,131650,185027,44,58083
12,1,38,7701,54823,119467,174290,44,58097
12,1,39,8517,58853,117378,176231,44,58071
12,1,40,8569,50205,120187,170392,44,58073
12,1,41,7993,50978,120539,171517,44,58086
12,1,42,8046,51745,116416,168161,44,58090
12,1,43,8550,50792,121512,172304,44,58078
12,1,44,7467,54090,131610,185700,44,58105
12,1,45,8014,55996,119829,175825,44,58088
12,1,46,7977,50524,117716,168240,44,58090
12,1,47,7982,55081,112563,167644,44,58087
12,1,48,6297,56264,146563,202827,44,58094
12,1,49,7977,57258,136559,193817,44,58090
12,1,50,7498,50912,121600,172512,44,58107
13,1,1,10000,26408,91838,118246,46,65774
13,1,2,10000,26438,82849,109287,46,65776
13,1,3,10000,26414,84305,110719,46,65775
13,1,4,10000,26895,77545,104440,46,65775
13,1,5,10000,26987,77694,104681,46,65772
13,1,6,9202,25500,83362,108862,46,65753
13,1,7,10000,28387,85285,113672,46,65773
13,1,8,10000,26473,103723,130196,46,65777
13,1,9,10000,26550,84486,111036,46,65775
13,1,10,10000,25932,85344,111276,46,65774
13,1,11,10000,24512,81185,105697,46,65774
13,1,12,10000,26883,82803,109686,46,65773
13,1,13,10000,26036,80654,106690,46,65775
13,1,14,10000,27000,81250,108250,46,65777
13,1,15,10000,25541,84718,110259,46,65772
13,1,16,10000,25727,81630,107357,46,65774
13,1,17,10000,25136,83845,108981,46,65776
13,1,18,10732,27330,82642,109972,46,65757
13,1,19,10000,26277,81565,107842,46,65774
13,1,20,10000,25926,85851,111777,46,65776
13,1,21,9234,25624,94339,119963,46,65798
13,1,22,8000,30867,97381,128248,46,65770
13,1,23,10000,28757,87269,116026,46,65775
13,1,24,10000,26469,79935,106404,46,65773
13,1,25,10000,25693,85992,111685,46,65774
13,1,26,10000,26422,78200,104622,46,65774
13,1,27,10000,26795,81611,108406,46,65776
13,1,28,10000,26427,80571,106998,46,65772
13,1,29,9975,25628,81673,107301,46,65773
13,1,30,10000,26552,81325,107877,46,65776
13,1,31,10000,25289,98701,123990,46,65777
13,1,32,10000,25256,81212,106468,46,65773
13,1,33,10000,26036,85473,111509,46,65772
13,1,34,8594,28842,91379,120221,46,65753
13,1,35,10000,28760,80910,109670,46,65775
13,1,36,9582,26501,82449,108950,46,65788
13,1,37,10633,26263,85473,111736,46,65758
13,1,38,10000,26796,80707,107503,46,65775
13,1,39,10000,25914,81659,107573,46,65774
13,1,40,9998,26809,80330,107139,46,65772
13,1,41,9232,26523,89358,115881,46,65796
13,1,42,10000,26317,82499,108816,46,65773
13,1,43,12655,26252,73294,99546,46,65777
13,1,44,10000,23749,86881,110630,46,65772
13,1,45,10000,26997,85696,112693,46,65776
13,1,46,10000,27297,89434,116731,46,65778
13,1,47,10000,30471,93178,123649,46,65777
13,1,48,9230,30352,86087,116439,46,65791
13,1,49,10000,26758,80393,107151,46,65775
13,1,50,10000,26419,84121,110540,46,65775
14,1,1,23203,16683,36119,52802,43,42570
14,1,2,22467,17572,36355,53927,43,42578
14,1,3,21632,16352,38825,55177,43,42587
14,1,4,21980,16543,38382,54925,43,42583
14,1,5,20726,19305,37533,56838,43,42598
14,1,6,21394,19586,35638,55224,43,42590
14,1,7,22305,16488,35586,52074,43,42579
14,1,8,22597,16709,37043,53752,43,42577
14,1,9,22550,16727,35561,52288,43,42576
14,1,10,22258,16354,38245,54599,43,42581
14,1,11,20563,18181,36666,54847,43,42599
14,1,12,23064,18173,35569,53742,43,42572
14,1,13,22944,16804,35947,52751,43,42573
14,1,14,19315,17652,46170,63822,43,42617
14,1,15,20031,19214,36195,55409,43,42606
14,1,16,22140,17844,35463,53307,43,42581
14,1,17,21207,17969,37250,55219,43,42592
14,1,18,21517,19965,35075,55040,43,42588
14,1,19,23077,16417,36496,52913,43,42572
14,1,20,19486,18043,36166,54209,43,42613
14,1,21,21975,16821,36600,53421,43,42583
14,1,22,22969,16780,37489,54269,43,42573
14,1,23,20136,18668,38219,56887,43,42605
14,1,24,21828,18196,35717,53913,43,42585
14,1,25,22269,17095,35466,52561,43,42580
14,1,26,22089,16901,35989,52890,43,42582
14,1,27,21254,17843,36593,54436,43,42592
14,1,28,22552,16563,38549,55112,43,42577
14,1,29,22886,16684,36187,52871,43,42573
14,1,30,21994,17832,34022,51854,43,42583
14,1,31,22640,17679,35042,52721,43,42576
14,1,32,21714,17601,35258,52859,43,42586
14,1,33,19374,19554,40862,60416,43,42615
14,1,34,20516,19608,35994,55602,43,42600
14,1,35,16705,17535,47817,65352,43,42592
14,1,36,18099,20844,42291,63135,43,42572
14,1,37,22340,17263,36550,53813,43,42579
14,1,38,23037,16939,34820,51759,43,42572
14,1,39,21706,16489,36585,53074,43,42586
14,1,40,22096,16534,36215,52749,43,42582
14,1,41,22905,16332,40662,56994,43,42574
14,1,42,19952,18959,38417,57376,43,42608
14,1,43,21500,18775,34401,53176,43,42589
14,1,44,22414,18054,36224,54278,43,42579
14,1,45,21148,16635,35016,51651,43,42592
14,1,46,21250,16553,38459,55012,43,42592
14,1,47,22518,16472,35028,51500,43,42577
14,1,48,21014,17964,36319,54283,43,42595
14,1,49,23131,16511,37463,53974,43,42572
14,1,50,22747,16738,35067,51805,43,42575
15,1,1,6258,68470,137881,206351,46,86880
15,1,2,6667,54571,136375,190946,46,86880
15,1,3,7058,54902,131558,186460,46,86865
15,1,4,7480,55218,130272,185490,46,86893
15,1,5,6850,55916,137995,193911,46,86881
15,1,6,7940,55891,140414,196305,46,86882
15,1,7,7005,56483,137297,193780,46,86868
15,1,8,7234,55847,132038,187885,46,86903
15,1,9,7047,54845,144901,199746,46,86871
15,1,10,7008,61554,144211,205765,46,86871
15,1,11,6289,68383,132270,200653,46,86876
15,1,12,8547,56699,128679,185378,46,86863
15,1,13,7986,55093,132907,188000,46,86880
15,1,14,7526,55856,123983,179839,46,86894
15,1,15,7981,56105,134015,190120,46,86878
15,1,16,7482,57116,117591,174707,46,86895
15,1,17,7500,48891,125019,173910,46,86894
15,1,18,7500,56839,128707,185546,46,86894
15,1,19,6451,57095,161612,218707,46,86867
15,1,20,7413,58251,135161,193412,46,86897
15,1,21,6657,65585,147620,213205,46,86882
15,1,22,7500,67325,121836,189161,46,86893
15,1,23,7030,55882,130696,186578,46,86869
15,1,24,6644,55890,141389,197279,46,86864
15,1,25,7982,55698,137176,192874,46,86882
15,1,26,6319,57290,139409,196699,46,86880
15,1,27,7501,55991,132522,188513,46,86890
15,1,28,7981,55116,135320,190436,46,86879
15,1,29,7050,56546,138005,194551,46,86865
15,1,30,8548,55581,133072,188653,46,86866
15,1,31,6656,60656,139657,200313,46,86862
15,1,32,7977,54900,127068,181968,46,86879
15,1,33,7022,55270,133665,188935,46,86874
15,1,34,6654,54859,133208,188067,46,86860
15,1,35,7066,55711,131627,187338,46,86871
15,1,36,7461,55327,130281,185608,46,86896
15,1,37,7663,56973,126871,183844,46,86884
15,1,38,6651,63035,128684,191719,46,86859
15,1,39,6675,54818,128914,183732,46,86882
15,1,40,8214,55168,124245,179413,46,86874
15,1,41,7059,56128,154724,210852,46,86868
15,1,42,6999,63474,144517,207991,46,86872
15,1,43,7486,53878,131425,185303,46,86893
15,1,44,7498,55843,139293,195136,46,86896
15,1,45,8822,54834,129758,184592,46,86879
15,1,46,7496,54345,139122,193467,46,86899
15,1,47,5713,60959,133161,194120,46,86895
15,1,48,4748,59016,328317,387333,46,86883
15,1,49,6788,74842,126129,200971,46,86877
15,1,50,5787,57311,151096,208407,46,86897
16,1,1,18860,17982,49353,67335,43,42777
16,1,2,16692,26382,42189,68571,43,42747
16,1,3,16568,21897,50597,72494,43,42749
16,1,4,16362,22397,50614,73011,43,42749
16,1,5,17967,24681,40380,65061,43,42729
16,1,6,17989,21761,44846,66607,43,42729
16,1,7,18542,20315,45715,66030,43,42741
16,1,8,16670,24223,43652,67875,43,42747
16,1,9,13743,23116,66002,89118,43,42735
16,1,10,13508,30402,51112,81514,43,42739
16,1,11,15933,25249,53295,78544,43,42761
16,1,12,15284,26706,51910,78616,43,42767
16,1,13,15376,25738,51492,77230,43,42769
16,1,14,14438,26403,53164,79567,43,42742
16,1,15,15880,25305,50481,75786,43,42757
16,1,16,16214,24670,52268,76938,43,42755
16,1,17,15592,24753,53292,78045,43,42764
16,1,18,14071,26340,60571,86911,43,42734
16,1,19,14835,26859,52348,79207,43,42738
16,1,20,15856,24285,52314,76599,43,42761
16,1,21,15620,25718,51525,77243,43,42764
16,1,22,14224,29143,50970,80113,43,42727
16,1,23,16090,23625,52622,76247,43,42756
16,1,24,15639,25482,51239,76721,43,42765
16,1,25,15642,24219,51531,75750,43,42763
16,1,26,14430,25197,53390,78587,43,42743
16,1,27,14758,26565,54986,81551,43,42739
16,1,28,13886,28638,56129,84767,43,42732
16,1,29,14251,27583,51312,78895,43,42727
16,1,30,14241,26644,53898,80542,43,42726
16,1,31,15613,24852,51794,76646,43,42763
16,1,32,15180,25026,52315,77341,43,42770
16,1,33,15204,25574,55250,80824,43,42770
16,1,34,15686,25577,52067,77644,43,42762
16,1,35,15105,25525,52674,78199,43,42773
16,1,36,14366,25120,56695,81815,43,42744
16,1,37,14794,24903,57519,82422,43,42740
16,1,38,14726,27308,51260,78568,43,42740
16,1,39,12594,24916,60362,85278,43,42757
16,1,40,15868,24791,53255,78046,43,42759
16,1,41,14846,25256,58204,83460,43,42781
16,1,42,14464,25607,58782,84389,43,42743
16,1,43,15343,25521,52507,78028,43,42768
16,1,44,15709,24999,51401,76400,43,42762
16,1,45,14601,25889,55428,81317,43,42745
16,1,46,16369,25501,50314,75815,43,42754
16,1,47,14334,27167,62876,90043,43,42728
16,1,48,12691,29647,60539,90186,43,42755
16,1,49,15158,25434,54925,80359,43,42773
16,1,50,15660,24130,54460,78590,43,42764
17,1,1,8082,44892,115277,160169,47,68378
17,1,2,8178,46204,114719,160923,47,68378
17,1,3,6616,44652,114114,158766,47,68364
17,1,4,7449,45228,117291,162519,47,68399
17,1,5,7411,44682,111109,155791,47,68399
17,1,6,5739,53439,127614,181053,47,68399
17,1,7,7428,48110,112219,160329,47,68397
17,1,8,7140,45914,118815,164729,47,68374
17,1,9,7633,45508,117061,162569,47,68391
17,1,10,8154,46356,114574,160930,47,68376
17,1,11,7176,46006,111263,157269,47,68411
17,1,12,9075,45990,111613,157603,47,68373
17,1,13,6232,45111,123723,168834,47,68379
17,1,14,7454,45697,124770,170467,47,68396
17,1,15,6996,45803,115573,161376,47,68373
17,1,16,9488,46673,117985,164658,47,68403
17,1,17,8515,49403,131109,180512,47,68366
17,1,18,7656,49592,125545,175137,47,68395
17,1,19,10000,45433,114686,160119,47,68391
17,1,20,10000,45291,115804,161095,47,68390
17,1,21,8241,46265,113277,159542,47,68376
17,1,22,6351,46439,111806,158245,47,68377
17,1,23,7035,46875,111605,158480,47,68372
17,1,24,7417,44754,117376,162130,47,68399
17,1,25,10000,46077,124753,170830,47,68387
17,1,26,7180,47149,109470,156619,47,68406
17,1,27,5946,45376,128306,173682,47,68390
17,1,28,7921,49272,125299,174571,47,68387
17,1,29,8808,45964,115863,161827,47,68382
17,1,30,7224,45507,117013,162520,47,68406
17,1,31,8181,46459,110177,156636,47,68378
17,1,32,7222,45595,117329,162924,47,68404
17,1,33,7405,46505,114017,160522,47,68399
17,1,34,7322,46261,118816,165077,47,68405
17,1,35,7447,45109,115570,160679,47,68398
17,1,36,9094,46591,107752,154343,47,68371
17,1,37,7603,45257,117358,162615,47,68397
17,1,38,5961,46340,131896,178236,47,68392
17,1,39,7179,53956,124700,178656,47,68409
17,1,40,8192,46694,118423,165117,47,68375
17,1,41,7460,46024,117627,163651,47,68397
17,1,42,7080,46263,117769,164032,47,68368
17,1,43,7059,46186,118481,164667,47,68374
17,1,44,7298,46214,122295,168509,47,68403
17,1,45,7654,56003,114975,170978,47,68391
17,1,46,7136,58560,116158,174718,47,68366
17,1,47,7690,45819,130917,176736,47,68395
17,1,48,8462,48206,112883,161089,47,68368
17,1,49,6992,46133,110199,156332,47,68372
17,1,50,9474,44599,111513,156112,47,68402
18,1,1,10000,41185,102101,143286,48,80540
18,1,2,10000,39910,96348,136258,48,80541
18,1,3,8832,39946,100171,140117,48,80531
18,1,4,10000,39041,103890,142931,48,80542
18,1,5,10000,40656,98967,139623,48,80540
18,1,6,8551,40713,98023,138736,48,80518
18,1,7,10000,39665,100287,139952,48,80544
18,1,8,9157,49312,110313,159625,48,80526
18,1,9,10000,47465,97299,144764,48,80541
18,1,10,10000,39198,96237,135435,48,80539
18,1,11,8204,40410,108576,148986,48,80526
18,1,12,7200,40495,121731,162226,48,80556
18,1,13,10000,41419,107471,148890,48,80542
18,1,14,10000,41015,96476,137491,48,80540
18,1,15,10000,39525,100096,139621,48,80543
18,1,16,10000,41858,102546,144404,48,80540
18,1,17,10000,40394,100005,140399,48,80539
18,1,18,9488,40714,108690,149404,48,80556
18,1,19,8806,45449,109221,154670,48,80532
18,1,20,7184,40756,106978,147734,48,80558
18,1,21,10000,39935,94103,134038,48,80535
18,1,22,6256,48192,121955,170147,48,80530
18,1,23,7536,47755,107446,155201,48,80549
18,1,24,7428,40130,102106,142236,48,80552
18,1,25,10000,39289,81354,120643,48,80537
18,1,26,10000,34454,101722,136176,48,80542
18,1,27,10000,40297,98524,138821,48,80540
18,1,28,10000,40249,97163,137412,48,80539
18,1,29,10000,38373,106841,145214,48,80538
18,1,30,10000,44582,118323,162905,48,80543
18,1,31,6256,46826,115171,161997,48,80529
18,1,32,10000,39997,100675,140672,48,80539
18,1,33,9696,38763,97177,135940,48,80548
18,1,34,10000,39930,99541,139471,48,80539
18,1,35,9624,39331,86241,125572,48,80549
18,1,36,7700,37400,104995,142395,48,80544
18,1,37,10000,39600,101896,141496,48,80538
18,1,38,8252,39428,110786,150214,48,80523
18,1,39,8244,42872,100493,143365,48,80522
18,1,40,10000,37671,90466,128137,48,80541
18,1,41,7696,41065,103607,144672,48,80543
18,1,42,9229,34606,90799,125405,48,80558
18,1,43,10000,40063,103225,143288,48,80543
18,1,44,10000,42347,101419,143766,48,80541
18,1,45,10000,40590,96616,137206,48,80540
18,1,46,8544,40279,91071,131350,48,80514
18,1,47,10000,35673,91688,127361,48,80540
18,1,48,10000,40078,91535,131613,48,80539
18,1,49,8522,35564,103111,138675,48,80519
18,1,50,9862,40704,100598,141302,48,80544
19,1,1,16132,19240,47990,67230,43,42723
19,1,2,19762,19782,42032,61814,43,42732
19,1,3,18988,20997,42498,63495,43,42743
19,1,4,20197,20074,43351,63425,43,42726
19,1,5,19050,20986,42952,63938,43,42742
19,1,6,18913,20924,40891,61815,43,42741
19,1,7,19538,21275,41477,62752,43,42737
19,1,8,18556,19738,46702,66440,43,42710
19,1,9,17181,23604,41321,64925,43,42705
19,1,10,19573,21556,42061,63617,43,42734
19,1,11,19216,20459,41141,61600,43,42740
19,1,12,20504,19679,42405,62084,43,42723
19,1,13,17971,20380,41945,62325,43,42696
19,1,14,19813,19860,41364,61224,43,42732
19,1,15,19333,19319,43559,62878,43,42739
19,1,16,19428,20731,41623,62354,43,42737
19,1,17,18006,23857,39312,63169,43,42696
19,1,18,16675,21463,51577,73040,43,42715
19,1,19,18714,23432,40494,63926,43,42747
19,1,20,19795,20801,40947,61748,43,42731
19,1,21,19101,20645,40529,61174,43,42742
19,1,22,18886,21583,40456,62039,43,42744
19,1,23,17305,18504,44962,63466,43,42705
19,1,24,20140,20960,40101,61061,43,42725
19,1,25,19164,21267,40066,61333,43,42739
19,1,26,18990,21069,43924,64993,43,42744
19,1,27,18301,21418,42560,63978,43,42691
19,1,28,17749,22383,42938,65321,43,42700
19,1,29,19575,19711,43069,62780,43,42736
19,1,30,19135,20390,37171,57561,43,42742
19,1,31,22857,17785,35907,53692,43,42696
19,1,32,19045,20505,41965,62470,43,42742
19,1,33,18750,21570,41868,63438,43,42748
19,1,34,13051,87585,7892,95477,43,42717
19,1,35,18591,20608,36286,56894,43,42707
19,1,36,19500,18024,64315,82339,43,42737
19,1,37,14088,32393,44907,77300,43,42695
19,1,38,17121,23779,41726,65505,43,42706
19,1,39,18493,21156,45112,66268,43,42712
19,1,40,19232,19767,44541,64308,43,42741
19,1,41,19428,18962,44386,63348,43,42738
19,1,42,20623,20795,45724,66519,43,42721
19,1,43,15460,24569,50025,74594,43,42735
19,1,44,17299,23855,56667,80522,43,42706
19,1,45,15741,25572,55187,80759,43,42729
19,1,46,14817,29168,46497,75665,43,42706
19,1,47,22392,17603,36701,54304,43,42700
19,1,48,19844,21262,43347,64609,43,42731
19,1,49,18994,21045,41028,62073,43,42743
19,1,50,18400,20180,42330,62510,43,42691
20,1,1,10000,29917,95622,125539,46,73083
20,1,2,9652,33400,99029,132429,46,73101
20,1,3,10000,31959,88317,120276,46,73075
20,1,4,10000,33986,94225,128211,46,73080
20,1,5,10000,32477,107837,140314,46,73078
20,1,6,10000,38324,99029,137353,46,73084
20,1,7,10000,33059,89553,122612,46,73084
20,1,8,9148,31073,90949,122022,46,73061
20,1,9,9826,32028,87253,119281,46,73086
20,1,10,9769,31989,80521,112510,46,73090
20,1,11,10000,27329,76947,104276,46,73079
20,1,12,10000,27228,83298,110526,46,73079
20,1,13,10000,32672,93906,126578,46,73081
20,1,14,10000,31490,93632,125122,46,73085
20,1,15,10000,26709,80625,107334,46,73080
20,1,16,8809,34388,102242,136630,46,73074
20,1,17,10000,34346,94947,129293,46,73085
20,1,18,10000,31648,89402,121050,46,73076
20,1,19,10000,27239,80204,107443,46,73074
20,1,20,11407,27220,98891,126111,46,73070
20,1,21,10000,32388,93988,126376,46,73078
20,1,22,10000,31967,90450,122417,46,73080
20,1,23,10000,32476,87767,120243,46,73089
20,1,24,10000,30663,92068,122731,46,73078
20,1,25,9379,33281,98069,131350,46,73103
20,1,26,9613,32848,95734,128582,46,73089
20,1,27,9414,33026,99781,132807,46,73100
20,1,28,10000,30700,79876,110576,46,73076
20,1,29,9922,29152,81109,110261,46,73090
20,1,30,9769,31303,100219,131522,46,73089
20,1,31,10000,33216,93932,127148,46,73079
20,1,32,10000,31611,92801,124412,46,73080
20,1,33,9528,31990,96921,128911,46,73104
20,1,34,9381,32282,100894,133176,46,73106
20,1,35,9117,32285,92218,124503,46,73060
20,1,36,9586,31896,97596,129492,46,73092
20,1,37,9130,31885,111635,143520,46,73067
20,1,38,10000,33985,94128,128113,46,73080
20,1,39,10000,32991,91063,124054,46,73085
20,1,40,10000,34896,92728,127624,46,73078
20,1,41,10000,32852,81844,114696,46,73085
20,1,42,10000,27267,86908,114175,46,73082
20,1,43,9624,31363,99158,130521,46,73098
20,1,44,9404,32350,96640,128990,46,73099
20,1,45,8763,31876,90074,121950,46,73077
20,1,46,10000,31737,84686,116423,46,73084
20,1,47,9490,34060,88598,122658,46,73094
20,1,48,9549,32414,90241,122655,46,73096
20,1,49,10000,32382,92875,125257,46,73084
20,1,50,8053,38652,111533,150185,46,73082
21,1,1,10000,37528,67443,104971,44,48145
21,1,2,10000,38010,75777,113787,44,48164
21,1,3,10000,36666,72686,109352,44,48146
21,1,4,10000,36563,73646,110209,44,48154
21,1,5,9918,36862,72049,108911,44,48160
21,1,6,10531,36757,77141,113898,44,48138
21,1,7,10000,36945,74993,111938,44,48154
21,1,8,12266,35999,63983,99982,44,48165
21,1,9,12100,31691,82718,114409,44,48173
21,1,10,10000,39825,82603,122428,44,48162
21,1,11,12201,33526,67233,100759,44,48175
21,1,12,10000,31829,68681,100510,44,48161
21,1,13,10000,31293,70461,101754,44,48154
21,1,14,10000,34747,74582,109329,44,48152
21,1,15,10767,36675,79941,116616,44,48148
21,1,16,10000,38394,76204,114598,44,48159
21,1,17,12150,34466,62852,97318,44,48161
21,1,18,10000,37152,75997,113149,44,48163
21,1,19,9867,36762,71773,108535,44,48157
21,1,20,10000,31612,75587,107199,44,48168
21,1,21,10000,41956,91689,133645,44,48148
21,1,22,10000,44802,73215,118017,44,48162
21,1,23,10000,37349,76127,113476,44,48167
21,1,24,10000,37404,75180,112584,44,48159
21,1,25,10000,36920,76538,113458,44,48161
21,1,26,10000,36174,73817,109991,44,48151
21,1,27,10000,37130,78574,115704,44,48165
21,1,28,10000,36926,73567,110493,44,48157
21,1,29,10458,36327,76311,112638,44,48157
21,1,30,9183,40322,77460,117782,44,48134
21,1,31,10000,38390,76426,114816,44,48147
21,1,32,10000,39079,84285,123364,44,48163
21,1,33,10000,38875,77453,116328,44,48171
21,1,34,10600,36930,71400,108330,44,48139
21,1,35,12129,31332,82603,113935,44,48162
21,1,36,10000,36548,77561,114109,44,48144
21,1,37,11302,37411,65090,102501,44,48151
21,1,38,10000,32512,78573,111085,44,48155
21,1,39,8954,37537,83401,120938,44,48150
21,1,40,10000,39151,77967,117118,44,48161
21,1,41,10000,37302,75003,112305,44,48149
21,1,42,10000,37140,75200,112340,44,48156
21,1,43,11767,31363,84644,116007,44,48132
21,1,44,10000,43369,81189,124558,44,48169
21,1,45,10000,39329,72811,112140,44,48158
21,1,46,10872,37300,78793,116093,44,48138
21,1,47,10000,38159,75869,114028,44,48168
21,1,48,9879,37637,76304,113941,44,48164
21,1,49,10000,36836,73963,110799,44,48161
21,1,50,10000,31374,82073,113447,44,48145
22,1,1,32523,13669,21567,35236,43,42540
22,1,2,37942,11811,20392,32203,43,42562
22,1,3,32656,13079,25064,38143,43,42539
22,1,4,36175,13389,17547,30936,43,42513
22,1,5,36584,12347,18417,30764,43,42511
22,1,6,30002,14461,24832,39293,43,42562
22,1,7,30574,14167,23517,37684,43,42556
22,1,8,30754,14004,24189,38193,43,42554
22,1,9,37804,13365,17750,31115,43,42563
22,1,10,37490,12082,18870,30952,43,42565
22,1,11,36457,11732,21128,32860,43,42512
22,1,12,26082,14897,29343,44240,43,42537
22,1,13,26035,18414,26910,45324,43,42537
22,1,14,31720,14300,25165,39465,43,42546
22,1,15,39051,11801,22390,34191,43,42553
22,1,16,31102,16618,20250,36868,43,42552
22,1,17,30610,14168,22836,37004,43,42556
22,1,18,31590,14120,23214,37334,43,42548
22,1,19,35630,12057,20233,32290,43,42517
22,1,20,31713,15071,21557,36628,43,42546
22,1,21,35070,12393,23384,35777,43,42521
22,1,22,31849,14529,24021,38550,43,42545
22,1,23,31644,14432,22376,36808,43,42547
22,1,24,32187,13723,24682,38405,43,42543
22,1,25,30470,14081,24667,38748,43,42558
22,1,26,29871,15436,23337,38773,43,42563
22,1,27,37887,13614,17965,31579,43,42562
22,1,28,33382,12935,23501,36436,43,42533
22,1,29,29245,13874,23965,37839,43,42507
22,1,30,25744,14344,28327,42671,43,42540
22,1,31,27918,15450,24075,39525,43,42519
22,1,32,30681,14312,29581,43893,43,42557
22,1,33,32006,13834,23858,37692,43,42544
22,1,34,32317,13676,22503,36179,43,42541
22,1,35,30056,15369,22942,38311,43,42561
22,1,36,30728,14238,23932,38170,43,42555
22,1,37,29637,15590,21509,37099,43,42505
22,1,38,29304,14418,23034,37452,43,42507
22,1,39,34628,13197,18400,31597,43,42524
22,1,40,35869,12023,22818,34841,43,42515
22,1,41,30844,14167,23358,37525,43,42554
22,1,42,31603,14385,24484,38869,43,42548
22,1,43,31648,13916,20489,34405,43,42546
22,1,44,31594,12196,24126,36322,43,42547
22,1,45,38085,13370,17420,30790,43,42560
22,1,46,38508,12338,17956,30294,43,42558
22,1,47,29838,14504,23800,38304,43,42563
22,1,48,30015,15726,24861,40587,43,42562
22,1,49,33736,16128,17813,33941,43,42531
22,1,50,34732,11700,23123,34823,43,42523
23,1,1,12260,28551,84721,113272,44,46252
23,1,2,10000,33612,75428,109040,44,46243
23,1,3,10000,34028,69885,103913,44,46238
23,1,4,10000,31837,75663,107500,44,46240
23,1,5,12740,29158,74186,103344,44,46238
23,1,6,10000,33098,68579,101677,44,46231
23,1,7,10000,33163,76911,110074,44,46235
23,1,8,10000,37498,75230,112728,44,46242
23,1,9,11049,35073,71353,106426,44,46214
23,1,10,10000,34547,69739,104286,44,46238
23,1,11,10000,32653,69858,102511,44,46229
23,1,12,10000,35150,68488,103638,44,46243
23,1,13,10000,34303,71798,106101,44,46242
23,1,14,10000,34071,71137,105208,44,46232
23,1,15,10000,33281,76354,109635,44,46246
23,1,16,11644,35727,66752,102479,44,46220
23,1,17,11155,33902,75793,109695,44,46212
23,1,18,10000,33743,90731,124474,44,46244
23,1,19,12066,28088,72859,100947,44,46253
23,1,20,12264,31650,63325,94975,44,46252
23,1,21,10000,30867,71159,102026,44,46236
23,1,22,10000,33445,66699,100144,44,46241
23,1,23,12650,30695,77674,108369,44,46250
23,1,24,10000,35272,69415,104687,44,46247
23,1,25,12823,29825,73845,103670,44,46240
23,1,26,12458,332965,-211722,121243,44,46240
23,1,27,10927,33915,91854,125769,44,46218
23,1,28,7436,34818,102988,137806,44,46244
23,1,29,10000,49811,76839,126650,44,46240
23,1,30,10000,32205,69485,101690,44,46239
23,1,31,10000,32748,68171,100919,44,46232
23,1,32,12156,31820,73560,105380,44,46254
23,1,33,10000,33013,71438,104451,44,46233
23,1,34,10000,33057,73711,106768,44,46232
23,1,35,13298,27102,76051,103153,44,46227
23,1,36,10000,38155,113789,151944,44,46247
23,1,37,8788,40410,82674,123084,44,46237
23,1,38,7934,52344,105252,157596,44,46238
23,1,39,10000,33100,88199,121299,44,46244
23,1,40,10000,32224,68493,100717,44,46243
23,1,41,12738,28747,66856,95603,44,46242
23,1,42,10000,32660,67795,100455,44,46233
23,1,43,13176,32165,57692,89857,44,46225
23,1,44,11689,33328,69307,102635,44,46223
23,1,45,12984,30517,74297,104814,44,46231
23,1,46,10964,35076,75337,110413,44,46220
23,1,47,10785,34165,71900,106065,44,46225
23,1,48,10000,34481,73629,108110,44,46244
23,1,49,10000,38916,85282,124198,44,46243
23,1,50,10000,38787,68890,107677,44,46245
24,1,1,9823,52930,110574,163504,45,54788
24,1,2,10000,51925,100104,152029,45,54773
24,1,3,7431,53086,104315,157401,45,54788
24,1,4,7890,53264,124651,177915,45,54775
24,1,5,8902,53258,100198,153456,45,54756
24,1,6,10000,51916,102473,154389,45,54781
24,1,7,7651,52904,104541,157445,45,54780
24,1,8,9843,52825,99993,152818,45,54775
24,1,9,8224,49350,110206,159556,45,54759
24,1,10,7948,60497,124375,184872,45,54771
24,1,11,10000,52831,97371,150202,45,54766
24,1,12,6906,51924,94099,146023,45,54780
24,1,13,8988,44598,98462,143060,45,54776
24,1,14,10000,54876,90549,145425,45,54758
24,1,15,10000,45540,98949,144489,45,54783
24,1,16,7924,52504,106197,158701,45,54783
24,1,17,8107,51957,99844,151801,45,54761
24,1,18,6808,51851,103957,155808,45,54764
24,1,19,10000,49380,100432,149812,45,54769
24,1,20,5944,55580,118264,173844,45,54813
24,1,21,10000,54194,92408,146602,45,54793
24,1,22,7920,44950,99802,144752,45,54782
24,1,23,8200,51519,105189,156708,45,54769
24,1,24,10000,55098,93095,148193,45,54773
24,1,25,10000,46359,89680,136039,45,54781
24,1,26,8446,45219,90281,135500,45,54760
24,1,27,9398,45009,91489,136498,45,54786
24,1,28,10000,46996,91080,138076,45,54773
24,1,29,7400,54194,110381,164575,45,54810
24,1,30,8232,51258,119093,170351,45,54756
24,1,31,8191,52819,95391,148210,45,54770
24,1,32,8196,48302,105397,153699,45,54771
24,1,33,9921,51150,87098,138248,45,54784
24,1,34,10000,45718,113884,159602,45,54763
24,1,35,9103,58238,97277,155515,45,54754
24,1,36,7683,52352,106340,158692,45,54777
24,1,37,10000,53914,102032,155946,45,54775
24,1,38,10000,52825,99907,152732,45,54764
24,1,39,7440,52362,102782,155144,45,54800
24,1,40,10000,50245,85178,135423,45,54770
24,1,41,7005,52527,109639,162166,45,54775
24,1,42,9088,52174,82931,135105,45,54758
24,1,43,10000,45333,126418,171751,45,54780
24,1,44,8814,53434,104374,157808,45,54770
24,1,45,10000,53242,102317,155559,45,54765
24,1,46,8757,53463,106452,159915,45,54758
24,1,47,10000,46912,87906,134818,45,54781
24,1,48,6426,50927,109540,160467,45,54772
24,1,49,10000,47671,86154,133825,45,54779
24,1,50,8776,49718,105776,155494,45,54772
25,1,1,12698,36556,75890,112446,43,43169
25,1,2,12858,37043,54649,91692,43,43147
25,1,3,13868,31817,57585,89402,43,43127
25,1,4,13962,31537,58915,90452,43,43130
25,1,5,13808,32656,53701,86357,43,43130
25,1,6,14059,30649,56521,87170,43,43118
25,1,7,13324,31825,60195,92020,43,43137
25,1,8,14427,32318,43783,76101,43,43147
25,1,9,13926,28478,61347,89825,43,43120
25,1,10,11755,41174,54249,95423,43,43138
25,1,11,15596,26502,53173,79675,43,43167
25,1,12,15967,27935,48263,76198,43,43142
25,1,13,14040,28511,62218,90729,43,43123
25,1,14,14778,27829,54202,82031,43,43129
25,1,15,13226,34307,57078,91385,43,43140
25,1,16,13773,32209,56874,89083,43,43133
25,1,17,13448,33371,57860,91231,43,43139
25,1,18,15537,27240,68023,95263,43,43160
25,1,19,10000,37194,63487,100681,43,43153
25,1,20,12583,34183,55150,89333,43,43160
25,1,21,13176,33156,58896,92052,43,43146
25,1,22,13705,31745,58810,90555,43,43130
25,1,23,13689,34474,53295,87769,43,43130
25,1,24,13922,32549,54643,87192,43,43123
25,1,25,13554,31636,55297,86933,43,43141
25,1,26,10000,31823,69900,101723,43,43164
25,1,27,13490,33878,49969,83847,43,43129
25,1,28,14218,29177,63746,92923,43,43122
25,1,29,13561,33734,58295,92029,43,43131
25,1,30,13804,33279,57448,90727,43,43133
25,1,31,15438,27318,56975,84293,43,43167
25,1,32,13162,33814,57890,91704,43,43149
25,1,33,14700,31347,44199,75546,43,43121
25,1,34,13762,29026,59035,88061,43,43127
25,1,35,13057,32527,58587,91114,43,43144
25,1,36,14580,32281,51814,84095,43,43122
25,1,37,10000,34248,67042,101290,43,43158
25,1,38,12417,37868,59504,97372,43,43175
25,1,39,13746,31847,57178,89025,43,43129
25,1,40,13702,31445,49068,80513,43,43123
25,1,41,14866,27950,56920,84870,43,43172
25,1,42,15294,31550,43433,74983,43,43162
25,1,43,14910,30780,48156,78936,43,43167
25,1,44,15381,27860,50516,78376,43,43171
25,1,45,13620,32610,53347,85957,43,43133
25,1,46,14424,30192,48836,79028,43,43137
25,1,47,15996,29475,48711,78186,43,43155
25,1,48,15483,27723,58210,85933,43,43157
25,1,49,12902,30271,64724,94995,43,43153
25,1,50,14506,27166,60431,87597,43,43137
26,1,1,43334,8911,17440,26351,43,42438
26,1,2,37761,10924,19524,30448,43,42475
26,1,3,35312,11254,20142,31396,43,42431
26,1,4,41744,9146,18122,27268,43,42448
26,1,5,33196,10577,23462,34039,43,42447
26,1,6,37293,11840,18751,30591,43,42419
26,1,7,44284,9306,19364,28670,43,42432
26,1,8,35383,12957,18481,31438,43,42431
26,1,9,37375,10882,19945,30827,43,42458
26,1,10,36470,11172,19166,30338,43,42422
26,1,11,36108,11383,19305,30688,43,42426
26,1,12,37525,11161,20794,31955,43,42477
26,1,13,33090,12975,19781,32756,43,42448
26,1,14,38116,11380,18741,30121,43,42472
26,1,15,36853,11227,19694,30921,43,42420
26,1,16,37046,10982,19098,30080,43,42419
26,1,17,39008,11182,18387,29569,43,42465
26,1,18,36008,11038,18543,29581,43,42426
26,1,19,34671,11081,19303,30384,43,42435
26,1,20,35284,11282,19267,30549,43,42430
26,1,21,40786,10956,13739,24695,43,42454
26,1,22,40200,9856,22476,32332,43,42458
26,1,23,33066,12839,20302,33141,43,42448
26,1,24,42436,9290,21638,30928,43,42444
26,1,25,34100,11348,19767,31115,43,42439
26,1,26,39138,11094,18841,29935,43,42465
26,1,27,38251,11070,18433,29503,43,42471
26,1,28,35276,10975,18894,29869,43,42431
26,1,29,38649,11341,19637,30978,43,42469
26,1,30,37810,11031,21454,32485,43,42475
26,1,31,33255,11569,20869,32438,43,42446
26,1,32,33638,11132,19031,30163,43,42443
26,1,33,42092,9140,16062,25202,43,42445
26,1,34,44652,9143,18305,27448,43,42430
26,1,35,41952,10654,13856,24510,43,42446
26,1,36,45145,9224,14948,24172,43,42428
26,1,37,35588,10572,19324,29896,43,42428
26,1,38,35240,11136,17718,28854,43,42431
26,1,39,44892,9157,18463,27620,43,42430
26,1,40,31154,12366,22248,34614,43,42464
26,1,41,32546,14056,20042,34098,43,42452
26,1,42,38218,10947,19027,29974,43,42471
26,1,43,38986,11313,18853,30166,43,42465
26,1,44,36428,10737,19256,29993,43,42424
26,1,45,34978,11026,19373,30399,43,42433
26,1,46,39026,12384,18866,31250,43,42465
26,1,47,34712,11536,20401,31937,43,42435
26,1,48,37018,10728,20115,30843,43,42420
26,1,49,33632,13454,19439,32893,43,42444
26,1,50,35205,12039,18578,30617,43,42431
27,1,1,12100,31893,95244,127137,44,56697
27,1,2,10000,39448,73324,112772,44,56684
27,1,3,10000,32826,70871,103697,44,56680
27,1,4,10000,32202,72824,105026,44,56681
27,1,5,10000,31922,376272,408194,44,56685
27,1,6,10000,40611,86400,127011,44,56685
27,1,7,10000,33621,93921,127542,44,56683
27,1,8,10000,39910,93282,133192,44,56682
27,1,9,7651,49548,92909,142457,44,56696
27,1,10,10000,29815,70428,100243,44,56685
27,1,11,13597,25796,72528,98324,44,56661
27,1,12,10000,32497,70242,102739,44,56684
27,1,13,13154,26783,73062,99845,44,56673
27,1,14,10000,31698,74982,106680,44,56687
27,1,15,9520,32305,75282,107587,44,56696
27,1,16,10000,36401,83608,120009,44,56685
27,1,17,9724,37012,101075,138087,44,56693
27,1,18,10000,44106,88110,132216,44,56691
27,1,19,10000,38915,104781,143696,44,56685
27,1,20,10000,39614,68527,108141,44,56686
27,1,21,12619,26905,81582,108487,44,56685
27,1,22,10821,33034,76963,109997,44,56675
27,1,23,13467,31063,62005,93068,44,56661
27,1,24,13122,28589,63172,91761,44,56676
27,1,25,10000,28527,78297,106824,44,56693
27,1,26,13270,27273,65471,92744,44,56675
27,1,27,10000,31873,76232,108105,44,56683
27,1,28,10000,33397,71630,105027,44,56677
27,1,29,10000,38641,79963,118604,44,56687
27,1,30,10000,36113,78432,114545,44,56692
27,1,31,13185,32686,53249,85935,44,56671
27,1,32,13305,29735,62769,92504,44,56673
27,1,33,13047,28479,64587,93066,44,56676
27,1,34,10000,32563,68972,101535,44,56675
27,1,35,10000,32931,74578,107509,44,56683
27,1,36,10000,33433,68899,102332,44,56689
27,1,37,11192,32803,79068,111871,44,56658
27,1,38,10000,31699,75658,107357,44,56685
27,1,39,10000,32991,75731,108722,44,56695
27,1,40,10000,35357,79387,114744,44,56687
27,1,41,10000,32485,71046,103531,44,56694
27,1,42,10000,32506,69967,102473,44,56680
27,1,43,10833,32703,76082,108785,44,56667
27,1,44,10000,32542,72823,105365,44,56685
27,1,45,10000,33390,68064,101454,44,56679
27,1,46,10000,32859,88011,120870,44,56681
27,1,47,13177,27237,69164,96401,44,56676
27,1,48,10000,32919,72292,105211,44,56679
27,1,49,10000,31983,71881,103864,44,56685
27,1,50,10000,33516,72262,105778,44,56689
28,1,1,14448,20805,68642,89447,45,55712
28,1,2,15285,22139,59137,81276,45,55737
28,1,3,16767,18718,49482,68200,45,55713
28,1,4,17439,19489,50890,70379,45,55705
28,1,5,17751,19918,58192,78110,45,55697
28,1,6,15639,23056,59171,82227,45,55730
28,1,7,17202,23308,49001,72309,45,55707
28,1,8,15789,19618,59527,79145,45,55727
28,1,9,13783,23113,65848,88961,45,55704
28,1,10,13791,25901,55828,81729,45,55700
28,1,11,17889,18556,59667,78223,45,55695
28,1,12,16231,22534,55446,77980,45,55717
28,1,13,15579,20332,60452,80784,45,55731
28,1,14,14895,22838,59558,82396,45,55745
28,1,15,16711,18540,52604,71144,45,55712
28,1,16,15548,22663,57368,80031,45,55733
28,1,17,15120,23028,58480,81508,45,55741
28,1,18,14647,23802,59811,83613,45,55708
28,1,19,13158,26613,64484,91097,45,55715
28,1,20,14379,25654,56177,81831,45,55710
28,1,21,14559,22515,60682,83197,45,55711
28,1,22,15536,21674,58205,79879,45,55732
28,1,23,15129,23785,57002,80787,45,55737
28,1,24,14971,23581,59033,82614,45,55741
28,1,25,14644,23260,60499,83759,45,55708
28,1,26,15642,23392,56730,80122,45,55730
28,1,27,14941,23068,59197,82265,45,55743
28,1,28,13854,25361,61535,86896,45,55702
28,1,29,15298,21450,68976,90426,45,55735
28,1,30,15027,21528,60806,82334,45,55742
28,1,31,14845,21627,58428,80055,45,55744
28,1,32,14602,23289,58903,82192,45,55709
28,1,33,18268,19199,49705,68904,45,55692
28,1,34,13452,21206,59030,80236,45,55705
28,1,35,17224,19865,48975,68840,45,55704
28,1,36,17443,19908,49721,69629,45,55704
28,1,37,14958,21545,57590,79135,45,55745
28,1,38,15937,22474,48041,70515,45,55726
28,1,39,16927,19609,50120,69729,45,55709
28,1,40,15597,19360,60945,80305,45,55733
28,1,41,14292,23154,56661,79815,45,55691
28,1,42,15618,21516,57994,79510,45,55728
28,1,43,14994,22902,60850,83752,45,55741
28,1,44,15158,21650,58022,79672,45,55740
28,1,45,15265,21545,69139,90684,45,55738
28,1,46,13714,25792,59709,85501,45,55703
28,1,47,14673,23230,58103,81333,45,55708
28,1,48,15368,22842,58846,81688,45,55734
28,1,49,14064,23419,57597,81016,45,55695
28,1,50,15242,21673,50702,72375,45,55737
29,1,1,13116,24625,73641,98266,45,59202
29,1,2,13701,26043,62833,88876,45,59189
29,1,3,12411,27397,72689,100086,45,59209
29,1,4,10000,32363,78360,110723,45,59217
29,1,5,13868,29537,56569,86106,45,59185
29,1,6,12746,26529,73484,100013,45,59209
29,1,7,12561,28131,65359,93490,45,59208
29,1,8,14748,23897,66749,90646,45,59197
29,1,9,12253,28986,71613,100599,45,59222
29,1,10,12355,28132,67933,96065,45,59218
29,1,11,14493,26372,60339,86711,45,59196
29,1,12,12308,27669,81292,108961,45,59221
29,1,13,13411,29503,56328,85831,45,59195
29,1,14,13305,24375,73986,98361,45,59198
29,1,15,12421,27875,72151,100026,45,59215
29,1,16,13542,27068,75406,102474,45,59192
29,1,17,12825,28263,58995,87258,45,59211
29,1,18,14647,23462,75958,99420,45,59190
29,1,19,12638,28232,72773,101005,45,59212
29,1,20,12506,28095,71206,99301,45,59216
29,1,21,12673,27702,68728,96430,45,59209
29,1,22,9283,30506,83559,114065,45,59231
29,1,23,10000,31701,73350,105051,45,59218
29,1,24,14128,22662,61854,84516,45,59190
29,1,25,13483,23216,72665,95881,45,59195
29,1,26,12129,26251,78663,104914,45,59224
29,1,27,12514,27614,77555,105169,45,59212
29,1,28,14445,24051,66330,90381,45,59195
29,1,29,13419,27607,56593,84200,45,59190
29,1,30,13912,23669,69410,93079,45,59187
29,1,31,10000,29641,74041,103682,45,59208
29,1,32,13116,28349,57330,85679,45,59196
29,1,33,14637,22278,64542,86820,45,59191
29,1,34,12190,27835,63104,90939,45,59218
29,1,35,14140,24436,70417,94853,45,59181
29,1,36,13606,27273,59244,86517,45,59194
29,1,37,12969,24732,75696,100428,45,59208
29,1,38,12444,28298,73779,102077,45,59216
29,1,39,10000,28018,73086,101104,45,59217
29,1,40,10000,29719,80416,110135,45,59210
29,1,41,10000,28569,75040,103609,45,59208
29,1,42,9488,31562,74736,106298,45,59218
29,1,43,10000,33038,74408,107446,45,59209
29,1,44,12741,27748,71121,98869,45,59204
29,1,45,12589,28122,67332,95454,45,59209
29,1,46,10000,28037,81929,109966,45,59209
29,1,47,12453,27759,59958,87717,45,59216
29,1,48,11290,26492,72298,98790,45,59201
29,1,49,12790,27728,67756,95484,45,59210
29,1,50,12278,28229,73561,101790,45,59221
30,1,1,8092,49578,121223,170801,44,59645
30,1,2,10000,41921,112943,154864,44,59630
30,1,3,10000,40770,84873,125643,44,59632
30,1,4,10000,34580,106823,141403,44,59631
30,1,5,9291,40959,89254,130213,44,59647
30,1,6,10543,34033,78537,112570,44,59635
30,1,7,9612,33069,98043,131112,44,59644
30,1,8,10000,31078,79218,110296,44,59620
30,1,9,10000,33244,93327,126571,44,59639
30,1,10,10000,32271,82960,115231,44,59635
30,1,11,10000,32460,110913,143373,44,59630
30,1,12,10000,32723,85613,118336,44,59630
30,1,13,10000,32258,97660,129918,44,59630
30,1,14,8462,39912,90627,130539,44,59600
30,1,15,10000,35622,92186,127808,44,59638
30,1,16,10000,34599,80481,115080,44,59631
30,1,17,10000,29951,80946,110897,44,59642
30,1,18,10000,30698,88435,119133,44,59645
30,1,19,10000,34713,93857,128570,44,59628
30,1,20,9259,36179,95781,131960,44,59646
30,1,21,10000,37616,87715,125331,44,59616
30,1,22,10000,37315,98785,136100,44,59633
30,1,23,10000,36890,90896,127786,44,59614
30,1,24,8892,33926,89490,123416,44,59610
30,1,25,10000,30143,83637,113780,44,59632
30,1,26,10000,34451,90015,124466,44,59615
30,1,27,10000,35137,90905,126042,44,59609
30,1,28,10000,34260,92675,126935,44,59619
30,1,29,10000,34552,94817,129369,44,59633
30,1,30,10000,35382,93550,128932,44,59626
30,1,31,10000,34050,91948,125998,44,59633
30,1,32,10000,34890,101129,136019,44,59649
30,1,33,9285,35601,97900,133501,44,59642
30,1,34,9525,39000,104010,143010,44,59633
30,1,35,7928,44472,96543,141015,44,59633
30,1,36,10000,32655,78092,110747,44,59628
30,1,37,9860,29981,92695,122676,44,59642
30,1,38,10000,33836,88664,122500,44,59627
30,1,39,10000,34671,96752,131423,44,59633
30,1,40,10000,35181,84415,119596,44,59630
30,1,41,10000,28670,77150,105820,44,59617
30,1,42,10000,31136,79294,110430,44,59617
30,1,43,10000,29484,377222,406706,44,59624
30,1,44,9127,36945,94430,131375,44,59615
30,1,45,10000,31552,100608,132160,44,59633
30,1,46,10000,30580,91346,121926,44,59618
30,1,47,8744,49713,101169,150882,44,59641
30,1,48,10000,33473,99721,133194,44,59640
30,1,49,10000,35144,91407,126551,44,59629
30,1,50,10000,35294,94767,130061,44,59628
31,1,1,10000,44517,85791,130308,43,43749
31,1,2,10000,52149,89367,141516,43,43741
31,1,3,5950,58053,136823,194876,43,43758
31,1,4,6082,56845,120833,177678,43,43746
31,1,5,5932,99793,91778,191571,43,43743
31,1,6,9928,50813,114191,165004,43,43742
31,1,7,7935,55824,87889,143713,43,43737
31,1,8,9103,51987,90951,142938,43,43727
31,1,9,10000,45355,88537,133892,43,43744
31,1,10,7646,52721,97759,150480,43,43749
31,1,11,8790,47309,81165,128474,43,43742
31,1,12,9105,50754,98321,149075,43,43727
31,1,13,10000,51203,95782,146985,43,43743
31,1,14,8151,58539,105293,163832,43,43738
31,1,15,10000,49027,79817,128844,43,43750
31,1,16,7656,52441,92292,144733,43,43744
31,1,17,10000,45351,83460,128811,43,43745
31,1,18,10000,52190,89415,141605,43,43743
31,1,19,9158,46839,83445,130284,43,43726
31,1,20,10000,45125,88710,133835,43,43750
31,1,21,8066,53747,100349,154096,43,43741
31,1,22,8474,53586,106865,160451,43,43725
31,1,23,10000,45785,80180,125965,43,43744
31,1,24,9908,44432,86908,131340,43,43747
31,1,25,8515,52595,114807,167402,43,43712
31,1,26,10000,51314,92126,143440,43,43736
31,1,27,8781,52178,86539,138717,43,43739
31,1,28,7791,45543,83425,128968,43,43746
31,1,29,8184,53969,95233,149202,43,43728
31,1,30,10000,52417,97289,149706,43,43751
31,1,31,9855,53883,96783,150666,43,43747
31,1,32,7590,54085,95034,149119,43,43753
31,1,33,10000,51404,91978,143382,43,43745
31,1,34,9141,51461,96323,147784,43,43727
31,1,35,6806,52196,101577,153773,43,43730
31,1,36,6553,58326,98490,156816,43,43727
31,1,37,7653,53904,92978,146882,43,43743
31,1,38,9757,53058,89226,142284,43,43746
31,1,39,10000,53611,89967,143578,43,43747
31,1,40,10000,51945,84051,135996,43,43742
31,1,41,8806,46394,82399,128793,43,43742
31,1,42,10000,52472,107333,159805,43,43745
31,1,43,10000,46065,87175,133240,43,43755
31,1,44,8462,52096,96436,148532,43,43722
31,1,45,8078,52246,99005,151251,43,43729
31,1,46,10000,52741,98847,151588,43,43745
31,1,47,9120,49510,96084,145594,43,43725
31,1,48,10000,47698,85517,133215,43,43741
31,1,49,10000,52252,95653,147905,43,43742
31,1,50,10000,52903,90613,143516,43,43745
32,1,1,10000,31442,85425,116867,46,73170
32,1,2,10000,32445,86015,118460,46,73172
32,1,3,8515,31095,90277,121372,46,73153
32,1,4,10000,37387,99514,136901,46,73176
32,1,5,10000,32441,87441,119882,46,73176
32,1,6,8515,39110,109265,148375,46,73151
32,1,7,10000,35476,88363,123839,46,73170
32,1,8,10000,31443,88653,120096,46,73171
32,1,9,9142,33906,106254,140160,46,73154
32,1,10,10000,36399,102682,139081,46,73173
32,1,11,10000,30410,93660,124070,46,73175
32,1,12,7954,36671,106681,143352,46,73168
32,1,13,7867,35629,102438,138067,46,73170
32,1,14,10000,32271,92554,124825,46,73172
32,1,15,8389,38115,92857,130972,46,73154
32,1,16,10000,31386,95894,127280,46,73175
32,1,17,7016,44398,116125,160523,46,73158
32,1,18,7420,41043,102672,143715,46,73183
32,1,19,10000,37677,98483,136160,46,73173
32,1,20,8824,33266,87414,120680,46,73163
32,1,21,7654,35176,110472,145648,46,73180
32,1,22,8643,37316,111885,149201,46,73151
32,1,23,10000,30265,90121,120386,46,73173
32,1,24,8150,37158,99030,136188,46,73159
32,1,25,10000,31692,88927,120619,46,73173
32,1,26,8319,35876,108746,144622,46,73160
32,1,27,9501,36779,109012,145791,46,73187
32,1,28,10000,34590,89149,123739,46,73175
32,1,29,8588,36207,106867,143074,46,73149
32,1,30,8155,41528,104174,145702,46,73160
32,1,31,8808,36820,90218,127038,46,73162
32,1,32,9165,32851,87518,120369,46,73151
32,1,33,8018,36513,115330,151843,46,73167
32,1,34,8757,37031,87726,124757,46,73169
32,1,35,10000,31660,101704,133364,46,73168
32,1,36,9176,35932,104217,140149,46,73153
32,1,37,7522,38369,103759,142128,46,73184
32,1,38,7437,36798,106139,142937,46,73185
32,1,39,8560,34809,111106,145915,46,73151
32,1,40,10000,43557,100207,143764,46,73174
32,1,41,10000,31772,88323,120095,46,73174
32,1,42,10000,31967,85545,117512,46,73168
32,1,43,7899,36081,102870,138951,46,73166
32,1,44,10000,33399,86452,119851,46,73175
32,1,45,7914,33424,101742,135166,46,73167
32,1,46,10000,36941,98424,135365,46,73179
32,1,47,10000,36293,87203,123496,46,73174
32,1,48,10000,32240,86648,118888,46,73176
32,1,49,10000,30508,91169,121677,46,73175
32,1,50,10000,33535,94208,127743,46,73175
33,1,1,7417,50769,113247,164016,45,66523
33,1,2,5746,62613,125731,188344,45,66527
33,1,3,5816,58308,119543,177851,45,66497
33,1,4,8512,51660,108511,160171,45,66486
33,1,5,10000,50919,117303,168222,45,66493
33,1,6,5932,59068,137415,196483,45,66523
33,1,7,5947,60175,128410,188585,45,66491
33,1,8,6122,59339,141570,200909,45,66525
33,1,9,5824,59644,131040,190684,45,66523
33,1,10,8130,60056,139161,199217,45,66496
33,1,11,5757,69809,126968,196777,45,66532
33,1,12,8739,55838,126400,182238,45,66504
33,1,13,7647,58809,111410,170219,45,66512
33,1,14,6592,51678,145499,197177,45,66486
33,1,15,5920,59600,131260,190860,45,66503
33,1,16,7399,59402,136738,196140,45,66520
33,1,17,7844,53560,110420,163980,45,66506
33,1,18,7252,50069,117258,167327,45,66506
33,1,19,6392,66500,121546,188046,45,66493
33,1,20,7611,54840,129034,183874,45,66517
33,1,21,7899,63820,124966,188786,45,66493
33,1,22,5802,65883,139559,205442,45,66531
33,1,23,7453,60277,125067,185344,45,66521
33,1,24,6508,60051,105895,165946,45,66492
33,1,25,7711,50773,137236,188009,45,66532
33,1,26,5936,61038,124389,185427,45,66497
33,1,27,5925,57267,114848,172115,45,66521
33,1,28,7058,50976,120435,171411,45,66508
33,1,29,7104,51738,118102,169840,45,66500
33,1,30,10000,51433,109911,161344,45,66501
33,1,31,7009,59429,129525,188954,45,66506
33,1,32,6793,56617,117318,173935,45,66493
33,1,33,6796,51788,112457,164245,45,66493
33,1,34,5929,58257,133025,191282,45,66530
33,1,35,5775,60010,137212,197222,45,66520
33,1,36,9183,59487,126639,186126,45,66473
33,1,37,5956,59114,138494,197608,45,66525
33,1,38,7400,56200,105301,161501,45,66521
33,1,39,10000,52262,108322,160584,45,66502
33,1,40,8804,52473,116508,168981,45,66503
33,1,41,5952,54996,130046,185042,45,66512
33,1,42,7267,54729,113432,168161,45,66526
33,1,43,7678,53299,135587,188886,45,66533
33,1,44,5936,59004,143167,202171,45,66513
33,1,45,9836,61381,120560,181941,45,66507
33,1,46,7430,55121,112567,167688,45,66522
33,1,47,5942,55854,144463,200317,45,66533
33,1,48,7951,65574,130530,196104,45,66495
33,1,49,10000,61196,134721,195917,45,66503
33,1,50,6492,58080,135250,193330,45,66488
34,1,1,5926,25238,187871,213109,45,75570
34,1,2,5731,27454,169207,196661,45,75575
34,1,3,5961,22490,183519,206009,45,75570
34,1,4,6780,22420,169950,192370,45,75556
34,1,5,6050,22751,171632,194383,45,75563
34,1,6,8656,25355,168739,194094,45,75541
34,1,7,5298,22954,178888,201842,45,75555
34,1,8,7605,22395,179007,201402,45,75571
34,1,9,10000,19420,148676,168096,45,75566
34,1,10,6595,19683,162822,182505,45,75545
34,1,11,5938,23458,193077,216535,45,75573
34,1,12,5678,23910,200316,224226,45,75581
34,1,13,6274,19621,157155,176776,45,75554
34,1,14,5950,22716,174841,197557,45,75567
34,1,15,9408,23180,169596,192776,45,75585
34,1,16,5656,20407,157732,178139,45,75577
34,1,17,10000,19987,150896,170883,45,75569
34,1,18,7953,20641,170987,191628,45,75560
34,1,19,5784,22136,155000,177136,45,75574
34,1,20,8800,19679,154768,174447,45,75558
34,1,21,6420,20196,152017,172213,45,75552
34,1,22,5806,19999,157441,177440,45,75577
34,1,23,6663,19706,169005,188711,45,75563
34,1,24,5931,21350,165246,186596,45,75572
34,1,25,7677,20415,160756,181171,45,75573
34,1,26,7462,19831,159578,179409,45,75579
34,1,27,5922,22879,184569,207448,45,75570
34,1,28,7006,23240,170703,193943,45,75550
34,1,29,5596,20199,159821,180020,45,75540
34,1,30,5247,23918,197410,221328,45,75560
34,1,31,5918,23888,182402,206290,45,75569
34,1,32,5882,23019,184535,207554,45,75571
34,1,33,5779,23700,177154,200854,45,75580
34,1,34,5294,24991,178815,203806,45,75553
34,1,35,5942,24598,195926,220524,45,75570
34,1,36,5784,24618,184793,209411,45,75578
34,1,37,5941,22832,178756,201588,45,75569
34,1,38,5911,23009,178826,201835,45,75571
34,1,39,5936,22694,179451,202145,45,75572
34,1,40,5407,23061,180990,204051,45,75547
34,1,41,5748,23204,176330,199534,45,75580
34,1,42,5922,19992,154910,174902,45,75571
34,1,43,6236,19606,155430,175036,45,75557
34,1,44,5930,19340,159847,179187,45,75570
34,1,45,5787,19636,183405,203041,45,75576
34,1,46,5986,23914,170707,194621,45,75569
34,1,47,7996,20048,543863,563911,45,75559
34,1,48,4942,24477,215447,239924,45,75553
34,1,49,5139,28719,185308,214027,45,75563
34,1,50,10000,19996,210560,230556,45,75572
35,1,1,10000,30575,88324,118899,47,90238
35,1,2,10000,26498,100140,126638,47,90268
35,1,3,8192,30981,107700,138681,47,90249
35,1,4,10000,32901,104319,137220,47,90267
35,1,5,10000,25142,102580,127722,47,90253
35,1,6,10000,30750,103979,134729,47,90270
35,1,7,9115,35954,115626,151580,47,90239
35,1,8,10000,31522,108850,140372,47,90257
35,1,9,9800,40763,132555,173318,47,90291
35,1,10,8031,36487,108361,144848,47,90256
35,1,11,10000,35358,101112,136470,47,90256
35,1,12,10000,30567,105396,135963,47,90267
35,1,13,8473,31626,99438,131064,47,90246
35,1,14,8810,29777,114462,144239,47,90251
35,1,15,10000,32004,98487,130491,47,90275
35,1,16,8544,31339,110990,142329,47,90241
35,1,17,7663,31842,108297,140139,47,90279
35,1,18,10000,28355,99289,127644,47,90274
35,1,19,10000,28929,107570,136499,47,90265
35,1,20,10000,29895,94167,124062,47,90286
35,1,21,10000,27083,89289,116372,47,90264
35,1,22,10000,27166,92277,119443,47,90263
35,1,23,10000,26552,93149,119701,47,90248
35,1,24,7918,32575,118281,150856,47,90258
35,1,25,10000,26560,90155,116715,47,90250
35,1,26,10000,26974,92321,119295,47,90260
35,1,27,10191,27133,111692,138825,47,90276
35,1,28,10000,32255,109095,141350,47,90262
35,1,29,10000,34401,112142,146543,47,90276
35,1,30,10000,29727,107428,137155,47,90249
35,1,31,10000,31193,83459,114652,47,90256
35,1,32,9128,28082,90990,119072,47,90262
35,1,33,10000,27695,99050,126745,47,90267
35,1,34,9895,32647,106887,139534,47,90272
35,1,35,10000,31820,99502,131322,47,90258
35,1,36,10000,32710,114950,147660,47,90269
35,1,37,8385,31906,132037,163943,47,90257
35,1,38,10000,32704,106663,139367,47,90260
35,1,39,10000,31561,104367,135928,47,90270
35,1,40,6273,32927,133712,166639,47,90272
35,1,41,7651,38439,124208,162647,47,90279
35,1,42,9027,30124,116647,146771,47,90265
35,1,43,10000,31620,99911,131531,47,90262
35,1,44,8740,32472,88668,121140,47,90245
35,1,45,10000,27386,88871,116257,47,90267
35,1,46,10000,26871,88684,115555,47,90244
35,1,47,10000,26894,93630,120524,47,90258
35,1,48,7880,31492,101438,132930,47,90261
35,1,49,9488,31388,104121,135509,47,90268
35,1,50,9997,31676,104014,135690,47,90272
36,1,1,17188,19049,48448,67497,44,52904
36,1,2,18308,19053,49723,68776,44,52889
36,1,3,21417,15918,39213,55131,44,52908
36,1,4,18660,16664,48263,64927,44,52906
36,1,5,17463,23551,44760,68311,44,52900
36,1,6,17671,19293,45824,65117,44,52898
36,1,7,19482,15944,50357,66301,44,52933
36,1,8,16180,19532,57666,77198,44,52921
36,1,9,15865,23969,46950,70919,44,52927
36,1,10,21630,17308,37984,55292,44,52907
36,1,11,20172,16609,48974,65583,44,52925
36,1,12,18405,19269,44931,64200,44,52887
36,1,13,18016,21370,44676,66046,44,52892
36,1,14,18232,21180,46668,67848,44,52890
36,1,15,17310,20563,47395,67958,44,52901
36,1,16,17134,20525,50295,70820,44,52905
36,1,17,16826,20074,50788,70862,44,52909
36,1,18,17745,20073,45725,65798,44,52896
36,1,19,20942,20343,35107,55450,44,52914
36,1,20,18260,18333,48229,66562,44,52890
36,1,21,19011,20645,35892,56537,44,52939
36,1,22,20922,16223,40653,56876,44,52917
36,1,23,18026,18237,48588,66825,44,52892
36,1,24,18468,20081,47050,67131,44,52909
36,1,25,18838,20576,36753,57329,44,52943
36,1,26,21043,17135,39263,56398,44,52914
36,1,27,18790,20987,49884,70871,44,52944
36,1,28,17518,22247,46007,68254,44,52900
36,1,29,17554,20188,46919,67107,44,52899
36,1,30,20776,17201,40052,57253,44,52917
36,1,31,20331,16020,46506,62526,44,52923
36,1,32,17616,20519,48797,69316,44,52899
36,1,33,18478,20749,36080,56829,44,52906
36,1,34,20568,17133,47469,64602,44,52918
36,1,35,17390,19976,47230,67206,44,52901
36,1,36,16897,21480,50121,71601,44,52909
36,1,37,20174,17358,37982,55340,44,52922
36,1,38,18220,19159,56251,75410,44,52892
36,1,39,18754,18958,40873,59831,44,52944
36,1,40,20840,17244,47323,64567,44,52915
36,1,41,19269,20108,38099,58207,44,52936
36,1,42,21304,16178,39928,56106,44,52908
36,1,43,18406,18714,47259,65973,44,52889
36,1,44,17646,18986,49298,68284,44,52898
36,1,45,16664,18703,57624,76327,44,52913
36,1,46,16472,23592,51302,74894,44,52919
36,1,47,17620,22461,45205,67666,44,52897
36,1,48,18277,20054,48324,68378,44,52888
36,1,49,17821,20218,45651,65869,44,52894
36,1,50,17006,19893,47823,67716,44,52908
37,1,1,13846,18326,81772,100098,48,96482
37,1,2,15538,15936,65114,81050,48,96509
37,1,3,13160,16851,71291,88142,48,96498
37,1,4,15230,17976,68942,86918,48,96511
37,1,5,12655,19795,79136,98931,48,96499
37,1,6,12021,20819,84716,105535,48,96516
37,1,7,15180,15948,64724,80672,48,96506
37,1,8,15258,17108,80953,98061,48,96512
37,1,9,15634,16218,63384,79602,48,96500
37,1,10,12975,16750,86360,103110,48,96496
37,1,11,13996,19187,65012,84199,48,96477
37,1,12,14758,19291,75758,95049,48,96477
37,1,13,15270,17452,65065,82517,48,96513
37,1,14,15378,16060,63296,79356,48,96504
37,1,15,14654,17389,80213,97602,48,96484
37,1,16,12554,21453,80548,102001,48,96504
37,1,17,12769,19000,79008,98008,48,96495
37,1,18,12199,23046,79587,102633,48,96510
37,1,19,12390,20381,84942,105323,48,96505
37,1,20,13336,18504,77683,96187,48,96487
37,1,21,12818,21228,73057,94285,48,96493
37,1,22,13258,19479,75920,95399,48,96495
37,1,23,13348,19815,77893,97708,48,96484
37,1,24,15672,17079,64766,81845,48,96500
37,1,25,10000,21506,83626,105132,48,96510
37,1,26,12715,21634,68809,90443,48,96497
37,1,27,12607,16207,96596,112803,48,96503
37,1,28,10000,23668,81302,104970,48,96511
37,1,29,15582,15897,63276,79173,48,96505
37,1,30,15586,17334,73131,90465,48,96504
37,1,31,13452,19133,76353,95486,48,96486
37,1,32,14062,18702,74069,92771,48,96473
37,1,33,12720,20976,75542,96518,48,96512
37,1,34,12609,18065,77384,95449,48,96496
37,1,35,10000,20842,79221,100063,48,96500
37,1,36,15046,19281,64267,83548,48,96515
37,1,37,13946,18718,82621,101339,48,96472
37,1,38,13080,20724,82017,102741,48,96499
37,1,39,12921,18310,77583,95893,48,96496
37,1,40,12588,19060,81147,100207,48,96505
37,1,41,15343,17836,63579,81415,48,96509
37,1,42,13003,18089,81884,99973,48,96495
37,1,43,13540,21026,67162,88188,48,96497
37,1,44,15548,16474,61246,77720,48,96505
37,1,45,15540,17600,64523,82123,48,96507
37,1,46,13840,17191,85593,102784,48,96480
37,1,47,14748,18210,76178,94388,48,96482
37,1,48,12948,18834,77765,96599,48,96493
37,1,49,15219,16161,76035,92196,48,96510
37,1,50,12331,21045,85041,106086,48,96517
38,1,1,14913,26055,66098,92153,43,42958
38,1,2,14010,27012,59769,86781,43,42914
38,1,3,14136,26935,60046,86981,43,42916
38,1,4,14653,26699,67405,94104,43,42930
38,1,5,13555,27457,61326,88783,43,42922
38,1,6,14236,26907,57331,84238,43,42910
38,1,7,13642,26910,60330,87240,43,42924
38,1,8,14731,26955,47108,74063,43,42923
38,1,9,12795,25340,75141,100481,43,42939
38,1,10,16104,24726,50857,75583,43,42934
38,1,11,14115,27289,59560,86849,43,42913
38,1,12,14378,26973,59805,86778,43,42924
38,1,13,16134,23148,52012,75160,43,42948
38,1,14,14572,23166,63024,86190,43,42929
38,1,15,14169,27875,59159,87034,43,42915
38,1,16,13996,27095,63093,90188,43,42915
38,1,17,13256,30505,62822,93327,43,42926
38,1,18,10000,109248,2587,111835,43,42939
38,1,19,14504,22597,58448,81045,43,42922
38,1,20,14818,23089,77420,100509,43,42921
38,1,21,13725,27399,57737,85136,43,42918
38,1,22,13996,26458,57497,83955,43,42914
38,1,23,15996,22888,56018,78906,43,42941
38,1,24,13416,26526,51512,78038,43,42924
38,1,25,14773,22757,63735,86492,43,42923
38,1,26,12211,30024,69103,99127,43,42951
38,1,27,9502,34271,86555,120826,43,42956
38,1,28,14059,31213,56580,87793,43,42915
38,1,29,13593,29126,53064,82190,43,42921
38,1,30,10000,28994,82008,111002,43,42944
38,1,31,14094,29190,55717,84907,43,42912
38,1,32,14427,26843,48771,75614,43,42929
38,1,33,14421,23084,59941,83025,43,42930
38,1,34,13780,26619,57312,83931,43,42916
38,1,35,13440,27779,63315,91094,43,42929
38,1,36,16308,24781,56220,81001,43,42936
38,1,37,14503,27290,48222,75512,43,42933
38,1,38,15343,23702,61765,85467,43,42956
38,1,39,14168,27984,57757,85741,43,42914
38,1,40,15758,25236,49271,74507,43,42942
38,1,41,14306,25038,62248,87286,43,42916
38,1,42,15700,24197,49711,73908,43,42946
38,1,43,15855,23058,56229,79287,43,42941
38,1,44,14228,26729,61499,88228,43,42913
38,1,45,13272,26648,70074,96722,43,42931
38,1,46,13256,29595,58274,87869,43,42930
38,1,47,15984,22938,57493,80431,43,42936
38,1,48,13818,26274,61542,87816,43,42924
38,1,49,13728,27443,56686,84129,43,42918
38,1,50,13609,28806,57704,86510,43,42921
39,1,1,8422,38791,129980,168771,48,79801
39,1,2,8474,37438,108379,145817,48,79803
39,1,3,6972,41121,120968,162089,48,79830
39,1,4,10000,36117,97949,134066,48,79826
39,1,5,7873,34278,129567,163845,48,79838
39,1,6,7506,37527,113056,150583,48,79857
39,1,7,9921,37593,112941,150534,48,79825
39,1,8,10000,37033,108297,145330,48,79811
39,1,9,10000,37066,107912,144978,48,79812
39,1,10,9530,30983,105088,136071,48,79836
39,1,11,8312,36509,109384,145893,48,79804
39,1,12,10000,37401,94614,132015,48,79826
39,1,13,7647,36615,116122,152737,48,79833
39,1,14,7518,37253,128030,165283,48,79840
39,1,15,10000,35440,113587,149027,48,79825
39,1,16,10000,35304,94725,130029,48,79796
39,1,17,10000,32169,96711,128880,48,79810
39,1,18,10000,33525,98261,131786,48,79830
39,1,19,8455,31633,104037,135670,48,79817
39,1,20,8203,37113,117103,154216,48,79816
39,1,21,7939,37011,114367,151378,48,79839
39,1,22,7807,37438,114400,151838,48,79828
39,1,23,8809,30129,102982,133111,48,79803
39,1,24,10000,37462,115622,153084,48,79818
39,1,25,10000,40795,118452,159247,48,79828
39,1,26,9026,31403,122804,154207,48,79808
39,1,27,10000,37662,112454,150116,48,79817
39,1,28,8431,37898,118915,156813,48,79798
39,1,29,6776,38148,114790,152938,48,79828
39,1,30,7448,36563,114183,150746,48,79852
39,1,31,8174,38064,129772,167836,48,79804
39,1,32,10000,38879,110181,149060,48,79826
39,1,33,10000,35519,108198,143717,48,79821
39,1,34,8832,31915,99613,131528,48,79818
39,1,35,7000,37550,127839,165389,48,79823
39,1,36,9163,35667,108024,143691,48,79809
39,1,37,8245,35850,95477,131327,48,79822
39,1,38,10000,34289,107731,142020,48,79810
39,1,39,10000,37126,104742,141868,48,79823
39,1,40,10000,31956,100232,132188,48,79815
39,1,41,10000,31910,96010,127920,48,79828
39,1,42,10000,32922,102887,135809,48,79819
39,1,43,7814,37403,122877,160280,48,79848
39,1,44,6411,37659,124353,162012,48,79830
39,1,45,7152,37455,112843,150298,48,79829
39,1,46,10000,37976,117320,155296,48,79830
39,1,47,9801,40837,111990,152827,48,79835
39,1,48,9519,38187,112235,150422,48,79825
39,1,49,10000,36531,108383,144914,48,79831
39,1,50,8475,32430,100381,132811,48,79808
40,1,1,10000,35415,78458,113873,47,84109
40,1,2,10000,31981,102321,134302,47,84111
40,1,3,10000,33767,103344,137111,47,84109
40,1,4,7386,33555,103938,137493,47,84124
40,1,5,9906,36204,87816,124020,47,84117
40,1,6,10000,28407,95931,124338,47,84100
40,1,7,10000,33631,101922,135553,47,84112
40,1,8,9517,41840,126779,168619,47,84156
40,1,9,9260,40272,96854,137126,47,84127
40,1,10,10000,28761,91424,120185,47,84109
40,1,11,10000,33863,103503,137366,47,84128
40,1,12,8784,35250,99209,134459,47,84108
40,1,13,10000,28847,88563,117410,47,84126
40,1,14,9528,30250,94785,125035,47,84140
40,1,15,10000,29286,95065,124351,47,84103
40,1,16,10000,34382,104739,139121,47,84092
40,1,17,10000,33224,101480,134704,47,84101
40,1,18,10000,33973,111268,145241,47,84112
40,1,19,8188,37714,104917,142631,47,84104
40,1,20,10000,29551,88242,117793,47,84113
40,1,21,8877,33263,118307,151570,47,84097
40,1,22,10000,30007,86593,116600,47,84105
40,1,23,10000,29898,90182,120080,47,84120
40,1,24,10000,28871,89441,118312,47,84092
40,1,25,10000,32944,106920,139864,47,84116
40,1,26,10000,33834,105125,138959,47,84114
40,1,27,8409,34142,114995,149137,47,84101
40,1,28,10000,30405,83049,113454,47,84105
40,1,29,8325,31994,110430,142424,47,84098
40,1,30,8952,39219,120781,160000,47,84107
40,1,31,8469,38385,111814,150199,47,84105
40,1,32,10000,34007,103629,137636,47,84117
40,1,33,9997,35211,102907,138118,47,84137
40,1,34,10000,28658,93947,122605,47,84108
40,1,35,9104,34463,107049,141512,47,84092
40,1,36,8402,34531,115331,149862,47,84128
40,1,37,9085,34159,103654,137813,47,84103
40,1,38,8179,33960,109700,143660,47,84112
40,1,39,10000,28134,92274,120408,47,84106
40,1,40,10000,29585,99649,129234,47,84114
40,1,41,7143,36359,116091,152450,47,84083
40,1,42,9130,34124,105366,139490,47,84103
40,1,43,10000,34407,97640,132047,47,84118
40,1,44,10027,28413,96982,125395,47,84119
40,1,45,9501,30135,91738,121873,47,84115
40,1,46,9926,29559,109415,138974,47,84111
40,1,47,10000,34108,91675,125783,47,84116
40,1,48,10000,29081,89976,119057,47,84098
40,1,49,8859,29513,90403,119916,47,84101
40,1,50,10000,33103,103732,136835,47,84108
41,1,1,10000,40366,115797,156163,46,61005
41,1,2,9178,33888,95964,129852,46,60984
41,1,3,8778,38947,95441,134388,46,61006
41,1,4,10000,37265,98155,135420,46,61004
41,1,5,7431,37551,100493,138044,46,61023
41,1,6,10000,38324,102056,140380,46,61009
41,1,7,10000,31853,83925,115778,46,61002
41,1,8,10000,32524,85327,117851,46,61005
41,1,9,10000,36546,97495,134041,46,61004
41,1,10,10000,37447,109586,147033,46,61003
41,1,11,10000,34441,90024,124465,46,61007
41,1,12,10000,37439,91979,129418,46,61009
41,1,13,9472,37706,99690,137396,46,61018
41,1,14,10000,32705,85121,117826,46,61006
41,1,15,10000,36871,98554,135425,46,61012
41,1,16,10000,38856,95880,134736,46,61015
41,1,17,10000,33467,87538,121005,46,61011
41,1,18,10000,38449,99805,138254,46,61009
41,1,19,10000,38700,96335,135035,46,60998
41,1,20,10000,39416,96765,136181,46,61002
41,1,21,10000,38943,96853,135796,46,61003
41,1,22,10000,32655,86380,119035,46,61006
41,1,23,10000,37184,91918,129102,46,61010
41,1,24,6262,39971,121116,161087,46,61004
41,1,25,10000,31572,87364,118936,46,61004
41,1,26,10000,33369,87477,120846,46,61006
41,1,27,10000,32039,90146,122185,46,61010
41,1,28,10000,33193,87590,120783,46,61005
41,1,29,10000,33161,83250,116411,46,61004
41,1,30,8966,32846,88973,121819,46,60989
41,1,31,10000,36913,95883,132796,46,61007
41,1,32,10000,39164,96367,135531,46,61005
41,1,33,10000,38540,100828,139368,46,60999
41,1,34,9108,41101,102074,143175,46,60990
41,1,35,10000,41222,97140,138362,46,60998
41,1,36,10000,38419,87576,125995,46,61003
41,1,37,10000,33229,86458,119687,46,61005
41,1,38,10000,34062,84607,118669,46,61002
41,1,39,10000,33999,85838,119837,46,61003
41,1,40,10000,38186,94616,132802,46,61000
41,1,41,8750,37480,96332,133812,46,60999
41,1,42,10000,31705,83214,114919,46,61000
41,1,43,8536,37594,104948,142542,46,60979
41,1,44,10000,38281,99942,138223,46,61008
41,1,45,10000,37969,107985,145954,46,61000
41,1,46,8460,44639,119953,164592,46,60987
41,1,47,10000,37559,98894,136453,46,61003
41,1,48,10000,37993,97363,135356,46,61001
41,1,49,8840,36895,87501,124396,46,60991
41,1,50,10000,32125,93208,125333,46,61002
42,1,1,8750,36574,110075,146649,46,71096
42,1,2,10000,32259,89265,121524,46,71102
42,1,3,10000,33037,86404,119441,46,71097
42,1,4,10000,32447,97111,129558,46,71111
42,1,5,10000,35718,89391,125109,46,71097
42,1,6,9721,33399,97374,130773,46,71125
42,1,7,10000,34262,100445,134707,46,71100
42,1,8,9378,35996,91175,127171,46,71121
42,1,9,10000,32822,91524,124346,46,71110
42,1,10,10000,33704,85553,119257,46,71115
42,1,11,10000,33694,84220,117914,46,71112
42,1,12,9164,33129,90907,124036,46,71092
42,1,13,10000,33177,98876,132053,46,71120
42,1,14,7430,38831,100940,139771,46,71131
42,1,15,10000,33789,88820,122609,46,71089
42,1,16,8337,36918,116832,153750,46,71108
42,1,17,8450,38071,97924,135995,46,71091
42,1,18,7650,37097,482911,520008,46,71113
42,1,19,7437,50199,108703,158902,46,71113
42,1,20,10000,42215,111355,153570,46,71099
42,1,21,7620,39116,156448,195564,46,71121
42,1,22,9220,32058,111520,143578,46,71138
42,1,23,10000,37382,99920,137302,46,71102
42,1,24,10000,36169,84934,121103,46,71101
42,1,25,7227,33038,111025,144063,46,71128
42,1,26,7954,41115,113366,154481,46,71098
42,1,27,9111,40059,99672,139731,46,71072
42,1,28,8786,37959,107821,145780,46,71094
42,1,29,7670,43604,122112,165716,46,71130
42,1,30,8362,36715,178487,215202,46,71103
42,1,31,10000,36610,128475,165085,46,71120
42,1,32,8462,42420,95388,137808,46,71094
42,1,33,8786,36698,104341,141039,46,71096
42,1,34,10000,38330,107904,146234,46,71117
42,1,35,9429,33564,94127,127691,46,71139
42,1,36,10000,32021,104677,136698,46,71101
42,1,37,8468,42717,111937,154654,46,71114
42,1,38,8029,46457,107633,154090,46,71122
42,1,39,8500,38598,91815,130413,46,71087
42,1,40,10000,33114,92810,125924,46,71105
42,1,41,7882,38299,106960,145259,46,71116
42,1,42,8548,37813,97160,134973,46,71080
42,1,43,10000,32388,90927,123315,46,71118
42,1,44,9645,32994,115541,148535,46,71114
42,1,45,8332,38915,102610,141525,46,71084
42,1,46,8188,37736,109817,147553,46,71095
42,1,47,6829,43722,140830,184552,46,71111
42,1,48,9907,41534,95050,136584,46,71090
42,1,49,8511,39038,101330,140368,46,71086
42,1,50,10000,35953,84540,120493,46,71106
43,1,1,16951,21343,47212,68555,45,53072
43,1,2,15519,26330,47964,74294,45,53094
43,1,3,17020,21513,55011,76524,45,53072
43,1,4,17774,26038,39472,65510,45,53060
43,1,5,13028,23594,64850,88444,45,53076
43,1,6,17071,23864,53975,77839,45,53071
43,1,7,15552,26590,39946,66536,45,53093
43,1,8,18205,22872,43403,66275,45,53055
43,1,9,18516,22213,43014,65227,45,53072
43,1,10,18355,22189,43242,65431,45,53053
43,1,11,17962,22181,45432,67613,45,53059
43,1,12,17600,21639,46933,68572,45,53063
43,1,13,14973,25639,55262,80901,45,53104
43,1,14,15236,26580,51594,78174,45,53099
43,1,15,15270,28855,51484,80339,45,53099
43,1,16,16162,24839,54091,78930,45,53084
43,1,17,18007,21264,51090,72354,45,53058
43,1,18,15498,26614,50790,77404,45,53095
43,1,19,16480,26242,44225,70467,45,53079
43,1,20,18054,22660,43463,66123,45,53056
43,1,21,16225,23212,60466,83678,45,53083
43,1,22,10000,31337,69326,100663,45,53080
43,1,23,16122,24769,51104,75873,45,53085
43,1,24,17710,23024,55865,78889,45,53063
43,1,25,14119,28431,65450,93881,45,53058
43,1,26,15066,24689,55818,80507,45,53102
43,1,27,15958,27152,56725,83877,45,53087
43,1,28,15888,27582,50930,78512,45,53088
43,1,29,15634,26298,46522,72820,45,53092
43,1,30,17521,22298,43154,65452,45,53064
43,1,31,17440,22362,53983,76345,45,53066
43,1,32,18072,23071,43296,66367,45,53056
43,1,33,15076,24954,59239,84193,45,53102
43,1,34,14964,28735,48571,77306,45,53104
43,1,35,18055,22256,46750,69006,45,53057
43,1,36,15499,26241,53732,79973,45,53095
43,1,37,14914,26928,53495,80423,45,53106
43,1,38,15046,25780,55050,80830,45,53104
43,1,39,13804,25976,60276,86252,45,53061
43,1,40,18085,21755,45859,67614,45,53057
43,1,41,18667,22234,43820,66054,45,53070
43,1,42,18193,22387,49673,72060,45,53055
43,1,43,13437,28974,62160,91134,45,53070
43,1,44,13738,29838,52758,82596,45,53063
43,1,45,15290,25281,53543,78824,45,53098
43,1,46,17649,21568,43239,64807,45,53062
43,1,47,18304,22194,40799,62993,45,53054
43,1,48,16202,23545,52205,75750,45,53083
43,1,49,15505,27714,53014,80728,45,53094
43,1,50,16299,25765,51133,76898,45,53081
44,1,1,10000,40470,70798,111268,45,58071
44,1,2,10000,42656,68616,111272,45,58051
44,1,3,10000,43668,79675,123343,45,58026
44,1,4,10000,39759,69905,109664,45,58025
44,1,5,10000,41947,83560,125507,45,58067
44,1,6,10000,49484,81107,130591,45,58039
44,1,7,10000,44981,81841,126822,45,58122
44,1,8,10000,45003,82157,127160,45,58044
44,1,9,10000,42383,70396,112779,45,58080
44,1,10,10000,40996,88419,129415,45,58100
44,1,11,10000,44985,68416,113401,45,58052
44,1,12,8916,39215,76360,115575,45,58095
44,1,13,10000,40912,103433,144345,45,58075
44,1,14,10000,56712,72375,129087,45,58077
44,1,15,10000,39407,79108,118515,45,58048
44,1,16,10000,44808,84317,129125,45,58145
44,1,17,10000,45228,77098,122326,45,58035
44,1,18,10000,38822,76643,115465,45,58099
44,1,19,10000,39147,68707,107854,45,58022
44,1,20,10000,43050,83421,126471,45,58119
44,1,21,10000,38167,77513,115680,45,58100
44,1,22,10000,44903,76977,121880,45,58106
44,1,23,10000,39425,72567,111992,45,58023
44,1,24,10000,43519,78830,122349,45,58123
44,1,25,10000,46655,81968,128623,45,58000
44,1,26,10000,45807,83702,129509,45,58087
44,1,27,10413,45177,71003,116180,45,58123
44,1,28,10000,39016,71938,110954,45,58080
44,1,29,10000,44418,82978,127396,45,58129
44,1,30,10000,40432,71098,111530,45,58016
44,1,31,9554,44320,81421,125741,45,58074
44,1,32,10000,38672,71790,110462,45,58047
44,1,33,10000,43056,89440,132496,45,58087
44,1,34,10000,47258,78704,125962,45,58119
44,1,35,10000,45948,102111,148059,45,58110
44,1,36,8467,51183,85818,137001,45,58034
44,1,37,10000,39620,73547,113167,45,58099
44,1,38,10000,43804,80888,124692,45,58073
44,1,39,10000,45937,79930,125867,45,58038
44,1,40,10000,44526,81234,125760,45,58035
44,1,41,9429,44818,86937,131755,45,58116
44,1,42,9523,44822,85325,130147,45,58080
44,1,43,10000,40018,67594,107612,45,57993
44,1,44,10000,43302,83175,126477,45,58052
44,1,45,10000,44062,82703,126765,45,58055
44,1,46,10000,47938,87521,135459,45,58096
44,1,47,10000,54293,77730,132023,45,58164
44,1,48,10000,37411,78547,115958,45,58081
44,1,49,10000,44260,78849,123109,45,58035
44,1,50,10000,39479,74628,114107,45,58119
45,1,1,24325,15600,31643,47243,43,42683
45,1,2,22972,19813,31392,51205,43,42637
45,1,3,25818,18442,24908,43350,43,42667
45,1,4,24688,16891,31717,48608,43,42679
45,1,5,21804,19519,33805,53324,43,42649
45,1,6,20881,23622,33043,56665,43,42660
45,1,7,21226,22185,31684,53869,43,42656
45,1,8,22010,19493,30800,50293,43,42647
45,1,9,24330,20439,23927,44366,43,42683
45,1,10,26719,16831,25838,42669,43,42659
45,1,11,27327,16052,26460,42512,43,42653
45,1,12,27861,17204,26544,43748,43,42647
45,1,13,23048,17749,33495,51244,43,42636
45,1,14,22744,20897,30824,51721,43,42639
45,1,15,22879,23381,29102,52483,43,42638
45,1,16,25380,18011,27882,45893,43,42671
45,1,17,21705,20826,30380,51206,43,42650
45,1,18,26526,16272,27978,44250,43,42660
45,1,19,26589,17081,31676,48757,43,42659
45,1,20,21610,20166,30546,50712,43,42652
45,1,21,22468,21847,23254,45101,43,42641
45,1,22,24855,16314,33943,50257,43,42677
45,1,23,27850,15657,33230,48887,43,42648
45,1,24,27410,17678,25031,42709,43,42652
45,1,25,27170,17379,29043,46422,43,42655
45,1,26,21116,19855,37280,57135,43,42657
45,1,27,20715,23782,28517,52299,43,42661
45,1,28,24579,19272,31135,50407,43,42680
45,1,29,22554,20327,30318,50645,43,42641
45,1,30,23575,18769,32029,50798,43,42691
45,1,31,22881,19009,34375,53384,43,42638
45,1,32,22855,19306,31759,51065,43,42638
45,1,33,25332,19112,24277,43389,43,42672
45,1,34,26010,17631,25181,42812,43,42664
45,1,35,24292,18040,27283,45323,43,42683
45,1,36,25687,16070,26445,42515,43,42669
45,1,37,22506,17302,34779,52081,43,42642
45,1,38,23640,18983,32201,51184,43,42691
45,1,39,26515,16401,31250,47651,43,42660
45,1,40,23941,20050,32549,52599,43,42687
45,1,41,22081,20779,33330,54109,43,42647
45,1,42,23738,19392,30798,50190,43,42690
45,1,43,23438,20663,31018,51681,43,42633
45,1,44,21296,20181,39233,59414,43,42655
45,1,45,26014,18027,26973,45000,43,42665
45,1,46,22501,19255,32852,52107,43,42642
45,1,47,22732,19194,32450,51644,43,42639
45,1,48,22930,19742,29589,49331,43,42637
45,1,49,26421,17633,24968,42601,43,42661
45,1,50,27217,16955,26712,43667,43,42653
46,1,1,36868,10012,21369,31381,43,42412
46,1,2,43183,9805,15512,25317,43,42431
46,1,3,42262,9879,16759,26638,43,42437
46,1,4,34413,12693,18181,30874,43,42429
46,1,5,38890,42560,-5074,37486,43,42458
46,1,6,29659,13250,27227,40477,43,42410
46,1,7,35284,12059,24479,36538,43,42423
46,1,8,25862,17024,25097,42121,43,42443
46,1,9,40647,11723,14698,26421,43,42446
46,1,10,34000,10310,20436,30746,43,42431
46,1,11,32248,13154,23441,36595,43,42446
46,1,12,33807,12911,18730,31641,43,42433
46,1,13,35890,10995,23270,34265,43,42419
46,1,14,31274,16976,19538,36514,43,42455
46,1,15,31130,12712,30874,43586,43,42456
46,1,16,32766,13087,22453,35540,43,42442
46,1,17,33526,15814,14269,30083,43,42437
46,1,18,36606,10342,20455,30797,43,42414
46,1,19,43509,10197,15721,25918,43,42429
46,1,20,42002,9944,15684,25628,43,42438
46,1,21,42241,9351,16821,26172,43,42436
46,1,22,46484,11458,13473,24931,43,42413
46,1,23,33296,11708,19900,31608,43,42438
46,1,24,41944,12230,14398,26628,43,42438
46,1,25,33764,10777,21168,31945,43,42434
46,1,26,41893,9196,19179,28375,43,42439
46,1,27,40999,11106,14568,25674,43,42444
46,1,28,38072,10295,17479,27774,43,42465
46,1,29,32376,11941,23347,35288,43,42445
46,1,30,36852,11003,19528,30531,43,42413
46,1,31,40340,10847,15158,26005,43,42448
46,1,32,36705,11038,18938,29976,43,42414
46,1,33,32908,12930,18004,30934,43,42440
46,1,34,35480,11403,18355,29758,43,42421
46,1,35,35664,11361,19487,30848,43,42421
46,1,36,36730,12213,16667,28880,43,42413
46,1,37,40650,9848,20035,29883,43,42447
46,1,38,36218,11627,19392,31019,43,42417
46,1,39,46239,9415,15289,24704,43,42414
46,1,40,43672,9339,16012,25351,43,42428
46,1,41,39338,9617,21166,30783,43,42455
46,1,42,39062,11214,19284,30498,43,42458
46,1,43,33438,11811,19863,31674,43,42436
46,1,44,37879,11120,15440,26560,43,42465
46,1,45,40567,9087,19816,28903,43,42447
46,1,46,32547,14101,20935,35036,43,42444
46,1,47,39403,14155,17278,31433,43,42456
46,1,48,43285,9762,15681,25443,43,42431
46,1,49,33082,11997,19277,31274,43,42439
46,1,50,34758,11448,20772,32220,43,42427
47,1,1,14578,24226,55225,79451,45,56190
47,1,2,15043,26621,43440,70061,45,56221
47,1,3,14874,22890,67034,89924,45,56226
47,1,4,13984,28135,56967,85102,45,56179
47,1,5,16693,25365,45295,70660,45,56194
47,1,6,15444,22538,56306,78844,45,56214
47,1,7,14888,26343,54852,81195,45,56224
47,1,8,15352,27182,52202,79384,45,56216
47,1,9,15398,27883,52848,80731,45,56216
47,1,10,16773,22819,47146,69965,45,56193
47,1,11,15214,28244,54841,83085,45,56219
47,1,12,15027,27116,54193,81309,45,56223
47,1,13,14733,27496,66715,94211,45,56188
47,1,14,12566,33273,64949,98222,45,56208
47,1,15,17409,21612,47385,68997,45,56185
47,1,16,18050,22581,45132,67713,45,56172
47,1,17,17886,23317,45653,68970,45,56176
47,1,18,14870,24353,59082,83435,45,56226
47,1,19,14883,25573,48155,73728,45,56225
47,1,20,18271,21581,44043,65624,45,56173
47,1,21,16942,22302,49236,71538,45,56192
47,1,22,15256,26362,51559,77921,45,56217
47,1,23,15626,26839,54281,81120,45,56210
47,1,24,16227,26903,41436,68339,45,56201
47,1,25,16560,23645,56476,80121,45,56195
47,1,26,15422,25357,55197,80554,45,56215
47,1,27,14758,30809,47716,78525,45,56188
47,1,28,14983,27358,52235,79593,45,56224
47,1,29,15727,24562,55332,79894,45,56209
47,1,30,15243,26744,56466,83210,45,56219
47,1,31,13161,31186,59027,90213,45,56195
47,1,32,13422,27939,56859,84798,45,56190
47,1,33,15576,25852,59677,85529,45,56211
47,1,34,17019,22518,51625,74143,45,56188
47,1,35,14918,26602,56505,83107,45,56225
47,1,36,16604,26430,45396,71826,45,56199
47,1,37,15712,25027,53876,78903,45,56210
47,1,38,14268,28817,57362,86179,45,56175
47,1,39,14804,27981,44674,72655,45,56185
47,1,40,17479,23681,53828,77509,45,56183
47,1,41,15460,26311,56583,82894,45,56215
47,1,42,14341,26962,54331,81293,45,56194
47,1,43,12758,27311,58068,85379,45,56200
47,1,44,15290,27876,52510,80386,45,56218
47,1,45,17716,21786,53069,74855,45,56181
47,1,46,14714,26292,59303,85595,45,56187
47,1,47,15300,27559,55333,82892,45,56216
47,1,48,15686,27202,61898,89100,45,56213
47,1,49,14938,24133,50737,74870,45,56225
47,1,50,15201,23018,61658,84676,45,56218
48,1,1,17044,30289,42995,73284,43,43072
48,1,2,15985,26629,53559,80188,43,43080
48,1,3,17623,28851,41944,70795,43,43062
48,1,4,15141,28739,53781,82520,43,43117
48,1,5,16917,26874,44604,71478,43,43065
48,1,6,13135,33281,59039,92320,43,43085
48,1,7,14444,31437,51814,83251,43,43084
48,1,8,15964,30476,48632,79108,43,43078
48,1,9,16819,26668,43696,70364,43,43075
48,1,10,17382,25979,41537,67516,43,43064
48,1,11,15016,28622,53303,81925,43,43104
48,1,12,14314,31921,50449,82370,43,43066
48,1,13,15036,30672,45962,76634,43,43104
48,1,14,17221,26850,50997,77847,43,43070
48,1,15,15049,30924,48607,79531,43,43102
48,1,16,13374,35435,54554,89989,43,43075
48,1,17,16800,32980,36797,69777,43,43079
48,1,18,14641,28798,53276,82074,43,43062
48,1,19,14420,31740,48124,79864,43,43064
48,1,20,14758,31300,50147,81447,43,43070
48,1,21,14744,31371,49727,81098,43,43064
48,1,22,14954,31691,51609,83300,43,43110
48,1,23,14822,30850,51144,81994,43,43064
48,1,24,16705,29731,41180,70911,43,43074
48,1,25,16416,28888,40752,69640,43,43072
48,1,26,13959,34132,45082,79214,43,43059
48,1,27,16332,26861,47840,74701,43,43084
48,1,28,14599,30552,41293,71845,43,43069
48,1,29,16671,26944,41251,68195,43,43070
48,1,30,17604,26795,43718,70513,43,43056
48,1,31,16821,26737,44447,71184,43,43081
48,1,32,17109,26564,41900,68464,43,43070
48,1,33,15219,28157,51798,79955,43,43106
48,1,34,14487,31218,48787,80005,43,43068
48,1,35,15964,27050,48904,75954,43,43085
48,1,36,15202,30553,45072,75625,43,43105
48,1,37,17220,27543,47997,75540,43,43071
48,1,38,15219,30656,41842,72498,43,43102
48,1,39,16675,27340,52659,79999,43,43068
48,1,40,17276,31056,39417,70473,43,43068
48,1,41,17244,27462,41081,68543,43,43067
48,1,42,15561,29230,53011,82241,43,43093
48,1,43,17228,26660,49369,76029,43,43071
48,1,44,16704,26743,42972,69715,43,43075
48,1,45,16237,28720,53066,81786,43,43082
48,1,46,14824,31093,49726,80819,43,43073
48,1,47,15229,30954,48902,79856,43,43107
48,1,48,14416,31320,50432,81752,43,43084
48,1,49,14084,30076,52190,82266,43,43058
48,1,50,15225,30709,49694,80403,43,43104
49,1,1,17682,17110,59383,76493,46,68857
49,1,2,15559,19106,69026,88132,46,68893
49,1,3,14391,22378,71060,93438,46,68872
49,1,4,15847,19111,61197,80308,46,68888
49,1,5,15027,18374,67521,85895,46,68899
49,1,6,16632,17377,62240,79617,46,68871
49,1,7,14529,20589,65642,86231,46,68866
49,1,8,13861,20091,79958,100049,46,68857
49,1,9,16598,19839,52325,72164,46,68873
49,1,10,14302,20596,68081,88677,46,68852
49,1,11,15735,18105,69689,87794,46,68888
49,1,12,14956,21323,65948,87271,46,68902
49,1,13,14330,22581,66638,89219,46,68850
49,1,14,14805,21939,63411,85350,46,68864
49,1,15,13785,22389,58729,81118,46,68862
49,1,16,16348,18374,54510,72884,46,68879
49,1,17,14994,18012,74164,92176,46,68903
49,1,18,17468,17814,53622,71436,46,68861
49,1,19,16538,19083,59463,78546,46,68876
49,1,20,12346,24093,75331,99424,46,68889
49,1,21,14836,23805,51308,75113,46,68862
49,1,22,16142,17495,55840,73335,46,68879
49,1,23,15034,323249,-211418,111831,46,68903
49,1,24,14324,18466,60068,78534,46,68849
49,1,25,15625,18061,90600,108661,46,68893
49,1,26,16242,17608,57259,74867,46,68879
49,1,27,13372,18400,76344,94744,46,68866
49,1,28,13598,23607,65275,88882,46,68863
49,1,29,14449,20158,67902,88060,46,68871
49,1,30,14938,22274,71277,93551,46,68902
49,1,31,10000,23725,78322,102047,46,68882
49,1,32,10000,24039,89678,113717,46,68884
49,1,33,10000,26093,74790,100883,46,68878
49,1,34,10000,26279,86775,113054,46,68884
49,1,35,14329,21560,62972,84532,46,68850
49,1,36,14222,22033,65631,87664,46,68855
49,1,37,15930,19552,63963,83515,46,68884
49,1,38,12571,25152,75750,100902,46,68884
49,1,39,14036,22616,68801,91417,46,68855
49,1,40,12751,26286,68765,95051,46,68881
49,1,41,16808,21405,52761,74166,46,68870
49,1,42,14846,19874,68342,88216,46,68904
49,1,43,16555,18033,63280,81313,46,68874
49,1,44,14084,21897,64546,86443,46,68857
49,1,45,14972,18118,57425,75543,46,68901
49,1,46,12964,22531,69457,91988,46,68874
49,1,47,17506,18450,54472,72922,46,68860
49,1,48,16384,17778,54198,71976,46,68876
49,1,49,13752,20981,68203,89184,46,68862
49,1,50,16170,17425,67806,85231,46,68881
50,1,1,29784,13777,20592,34369,43,42548
50,1,2,30038,12626,26290,38916,43,42545
50,1,3,25759,15276,29922,45198,43,42524
50,1,4,31864,17309,17593,34902,43,42529
50,1,5,28776,13804,26352,40156,43,42495
50,1,6,29004,14143,26043,40186,43,42494
50,1,7,34797,13688,18727,32415,43,42507
50,1,8,31440,12548,25961,38509,43,42533
50,1,9,28110,15550,28283,43833,43,42502
50,1,10,29896,14437,25400,39837,43,42547
50,1,11,28677,13850,28800,42650,43,42497
50,1,12,26682,16174,26569,42743,43,42514
50,1,13,30828,14103,24647,38750,43,42538
50,1,14,28305,13577,25559,39136,43,42499
50,1,15,33507,13324,19912,33236,43,42516
50,1,16,33484,13016,20244,33260,43,42517
50,1,17,36270,11938,20283,32221,43,42496
50,1,18,31666,14036,19222,33258,43,42531
50,1,19,34198,12691,20549,33240,43,42511
50,1,20,30871,12954,30604,43558,43,42537
50,1,21,24300,17850,30423,48273,43,42540
50,1,22,25923,18021,27357,45378,43,42521
50,1,23,31720,11927,26551,38478,43,42530
50,1,24,29185,15702,25049,40751,43,42492
50,1,25,28568,14088,25453,39541,43,42497
50,1,26,35548,12956,19865,32821,43,42502
50,1,27,27865,13867,26068,39935,43,42503
50,1,28,27026,14490,25654,40144,43,42510
50,1,29,25869,16067,41570,57637,43,42523
50,1,30,16231,26593,40884,67477,43,42519
50,1,31,18544,24415,32257,56672,43,42508
50,1,32,27421,19094,18451,37545,43,42507
50,1,33,25526,14689,31520,46209,43,42526
50,1,34,24792,16513,24487,41000,43,42533
50,1,35,34185,12358,25013,37371,43,42510
50,1,36,28171,16816,23766,40582,43,42500
50,1,37,29743,14269,28682,42951,43,42548
50,1,38,34120,11874,24109,35983,43,42511
50,1,39,28740,14944,21970,36914,43,42496
50,1,40,30674,14186,23968,38154,43,42539
50,1,41,23170,18208,27475,45683,43,42491
50,1,42,31389,12430,26370,38800,43,42533
50,1,43,27242,14502,26653,41155,43,42508
50,1,44,28956,14310,25995,40305,43,42494
50,1,45,34906,12319,21098,33417,43,42506
50,1,46,31134,12157,29448,41605,43,42536
50,1,47,26862,17258,23443,40701,43,42512
50,1,48,28078,14375,24972,39347,43,42500
50,1,49,25633,16639,28822,45461,43,42524
50,1,50,33313,11861,24887,36748,43,42518
51,1,1,7140,44387,148492,192879,46,76727
51,1,2,7645,43889,130759,174648,46,76776
51,1,3,10000,39801,123810,163611,46,76767
51,1,4,8732,38372,112700,151072,46,76744
51,1,5,10000,39329,133905,173234,46,76799
51,1,6,7802,39623,120200,159823,46,76767
51,1,7,5806,43827,140397,184224,46,76837
51,1,8,5929,47606,158287,205893,46,76782
51,1,9,7644,40746,110227,150973,46,76756
51,1,10,7597,38391,110315,148706,46,76751
51,1,11,9561,38807,114516,153323,46,76796
51,1,12,7383,38124,152702,190826,46,76839
51,1,13,7648,42568,116567,159135,46,76783
51,1,14,10000,43128,109246,152374,46,76746
51,1,15,6082,41912,137836,179748,46,76773
51,1,16,6321,40296,118812,159108,46,76771
51,1,17,6720,40026,139033,179059,46,76787
51,1,18,5917,47650,139057,186707,46,76773
51,1,19,5865,44840,130790,175630,46,76791
51,1,20,5682,44049,134030,178079,46,76848
51,1,21,7778,42949,124895,167844,46,76797
51,1,22,10000,38299,123492,161791,46,76748
51,1,23,8781,49292,132077,181369,46,76793
51,1,24,7460,43188,116604,159792,46,76747
51,1,25,7196,39764,130106,169870,46,76782
51,1,26,8492,42538,115132,157670,46,76744
51,1,27,7707,38258,139456,177714,46,76814
51,1,28,5796,44180,135710,179890,46,76819
51,1,29,5960,43554,154804,198358,46,76864
51,1,30,6261,51534,144685,196219,46,76791
51,1,31,7671,44261,125829,170090,46,76830
51,1,32,10000,44685,131380,176065,46,76755
51,1,33,7906,43818,118537,162355,46,76762
51,1,34,10000,37296,115889,153185,46,76768
51,1,35,10000,38247,125182,163429,46,76766
51,1,36,6600,43556,133809,177365,46,76789
51,1,37,8424,44838,111093,155931,46,76722
51,1,38,6601,37177,131434,168611,46,76727
51,1,39,5822,44289,131656,175945,46,76871
51,1,40,7609,39919,124157,164076,46,76794
51,1,41,6730,40890,121400,162290,46,76809
51,1,42,7429,37908,117845,155753,46,76783
51,1,43,5835,42948,148449,191397,46,76845
51,1,44,7910,39220,113057,152277,46,76781
51,1,45,7650,41640,131974,173614,46,76804
51,1,46,6979,43520,132606,176126,46,76757
51,1,47,6810,39781,116412,156193,46,76753
51,1,48,7456,38990,132991,171981,46,76798
51,1,49,7698,41824,111603,153427,46,76788
51,1,50,8434,36632,148579,185211,46,76779
52,1,1,2013,22269,514442,536711,115,695994
52,1,2,2354,20552,508219,528771,115,695953
52,1,3,2985,19230,467058,486288,115,695954
52,1,4,2943,18920,471653,490573,115,695946
52,1,5,2344,20419,555989,576408,115,695934
52,1,6,2770,22469,563658,586127,115,695964
52,1,7,3018,21979,570164,592143,115,695949
52,1,8,3410,21723,470531,492254,115,695955
52,1,9,2509,21506,601543,623049,115,695932
52,1,10,2218,30583,633805,664388,115,695970
52,1,11,2335,22356,611272,633628,115,695963
52,1,12,3182,21758,535694,557452,115,695913
52,1,13,2907,18820,462917,481737,115,695948
52,1,14,3458,18354,458782,477136,115,695938
52,1,15,2740,22157,569653,591810,115,695968
52,1,16,2772,22975,573055,596030,115,695958
52,1,17,2865,18882,494382,513264,115,695952
52,1,18,1917,23154,576123,599277,115,696013
52,1,19,2350,21795,614837,636632,115,695958
52,1,20,2655,22371,577088,599459,115,695997
52,1,21,2444,22834,570025,592859,115,695948
52,1,22,2248,22947,603442,626389,115,695966
52,1,23,1962,23352,590893,614245,115,695995
52,1,24,3004,18750,544302,563052,115,695943
52,1,25,2408,21681,518690,540371,115,695946
52,1,26,1936,23384,606474,629858,115,695994
52,1,27,2522,23620,575484,599104,115,695936
52,1,28,3304,19279,533344,552623,115,695916
52,1,29,2331,22355,588986,611341,115,695953
52,1,30,3411,19015,538430,557445,115,695947
52,1,31,2977,23022,565816,588838,115,695943
52,1,32,3140,22201,570499,592700,115,695927
52,1,33,2840,21831,488877,510708,115,695958
52,1,34,3207,18607,472953,491560,115,695927
52,1,35,1981,26299,644539,670838,115,695995
52,1,36,2593,26044,604308,630352,115,695984
52,1,37,2925,22087,458475,480562,115,695948
52,1,38,2360,20076,600270,620346,115,695954
52,1,39,2493,22252,554248,576500,115,695932
52,1,40,2907,19564,573223,592787,115,695956
52,1,41,2367,23498,495790,519288,115,695952
52,1,42,3051,19432,459120,478552,115,695941
52,1,43,2292,23202,628315,651517,115,695962
52,1,44,2617,24161,596180,620341,115,695973
52,1,45,2938,21606,559827,581433,115,695950
52,1,46,2245,26415,512450,538865,115,695958
52,1,47,2982,19349,1548853,1568202,115,695943
52,1,48,1938,22296,654891,677187,115,696010
52,1,49,3814,18646,589719,608365,115,695940
52,1,50,2143,24537,642622,667159,115,695965
53,1,1,13708,26832,57773,84605,44,56404
53,1,2,14877,25104,58034,83138,44,56440
53,1,3,16852,20413,48127,68540,44,56410
53,1,4,12603,22996,77971,100967,44,56433
53,1,5,12696,29013,81279,110292,44,56430
53,1,6,12926,28827,54551,83378,44,56424
53,1,7,13904,27876,54977,82853,44,56403
53,1,8,14752,25263,62411,87674,44,56412
53,1,9,15104,27174,63061,90235,44,56442
53,1,10,15015,25541,57034,82575,44,56443
53,1,11,16738,20550,58702,79252,44,56418
53,1,12,16122,24099,44393,68492,44,56420
53,1,13,16255,21675,59319,80994,44,56421
53,1,14,17056,25209,42798,68007,44,56405
53,1,15,17433,21737,50548,72285,44,56405
53,1,16,15250,23362,61871,85233,44,56441
53,1,17,17156,21059,55913,76972,44,56406
53,1,18,12835,27270,70364,97634,44,56427
53,1,19,14006,29107,55264,84371,44,56397
53,1,20,15073,25575,68300,93875,44,56446
53,1,21,15242,25362,55903,81265,44,56431
53,1,22,15440,26244,44222,70466,44,56434
53,1,23,14942,22402,61760,84162,44,56448
53,1,24,17215,20465,59813,80278,44,56402
53,1,25,15322,25758,60686,86444,44,56439
53,1,26,16083,22989,48542,71531,44,56420
53,1,27,16747,23375,50178,73553,44,56417
53,1,28,14583,25661,51508,77169,44,56413
53,1,29,17815,21805,47980,69785,44,56393
53,1,30,17227,22002,47849,69851,44,56403
53,1,31,16776,21405,53152,74557,44,56413
53,1,32,17278,21815,49158,70973,44,56405
53,1,33,15206,23490,58783,82273,44,56435
53,1,34,14612,26370,61418,87788,44,56413
53,1,35,15212,26123,45906,72029,44,56437
53,1,36,15248,24550,66201,90751,44,56440
53,1,37,12715,32429,54848,87277,44,56420
53,1,38,15060,25416,59629,85045,44,56443
53,1,39,15442,26635,56481,83116,44,56436
53,1,40,17122,21698,49132,70830,44,56405
53,1,41,17623,21431,47387,68818,44,56397
53,1,42,16810,21493,55724,77217,44,56413
53,1,43,14580,25088,58476,83564,44,56410
53,1,44,15367,25019,62412,87431,44,56443
53,1,45,16322,21848,50364,72212,44,56424
53,1,46,16654,21078,59065,80143,44,56416
53,1,47,14458,25701,53397,79098,44,56412
53,1,48,17470,24421,47647,72068,44,56402
53,1,49,15511,23899,58571,82470,44,56431
53,1,50,15064,25679,57760,83439,44,56444
54,1,1,17575,17136,65716,82852,44,50918
54,1,2,15549,21582,60434,82016,44,50949
54,1,3,12580,22737,71652,94389,44,50939
54,1,4,15543,24186,46763,70949,44,50949
54,1,5,15062,20601,67511,88112,44,50957
54,1,6,17797,17660,57185,74845,44,50915
54,1,7,16639,21504,62151,83655,44,50931
54,1,8,14101,23847,58750,82597,44,50912
54,1,9,17166,20997,45868,66865,44,50924
54,1,10,16298,18278,61353,79631,44,50937
54,1,11,16227,20696,48744,69440,44,50938
54,1,12,17200,19342,50318,69660,44,50922
54,1,13,17840,17675,52067,69742,44,50914
54,1,14,16968,19445,53858,73303,44,50927
54,1,15,15314,20748,48556,69304,44,50953
54,1,16,16386,18007,60382,78389,44,50935
54,1,17,18004,17480,53495,70975,44,50912
54,1,18,15393,21028,49572,70600,44,50951
54,1,19,14296,18544,58198,76742,44,50908
54,1,20,15771,21617,55760,77377,44,50945
54,1,21,15112,21425,58645,80070,44,50956
54,1,22,13156,24115,73605,97720,44,50929
54,1,23,17036,17714,52033,69747,44,50925
54,1,24,17776,18649,49193,67842,44,50916
54,1,25,14996,21559,61090,82649,44,50959
54,1,26,15241,22338,59865,82203,44,50953
54,1,27,14462,22368,59822,82190,44,50927
54,1,28,14662,22650,58315,80965,44,50923
54,1,29,14618,25425,44342,69767,44,50924
54,1,30,14440,19769,67669,87438,44,50928
54,1,31,15222,23414,55974,79388,44,50954
54,1,32,17270,18978,49503,68481,44,50922
54,1,33,17440,17856,50163,68019,44,50919
54,1,34,17530,17848,48532,66380,44,50918
54,1,35,15391,19345,57679,77024,44,50951
54,1,36,14259,23849,58469,82318,44,50908
54,1,37,16022,23196,47840,71036,44,50941
54,1,38,15870,19636,59986,79622,44,50942
54,1,39,16896,18020,50142,68162,44,50928
54,1,40,15475,18542,61663,80205,44,50951
54,1,41,14305,24264,66806,91070,44,50908
54,1,42,15654,21938,57962,79900,44,50947
54,1,43,14763,22699,47866,70565,44,50921
54,1,44,15128,18482,62520,81002,44,50956
54,1,45,13239,21776,61655,83431,44,50926
54,1,46,16981,19825,47890,67715,44,50926
54,1,47,17526,18212,48620,66832,44,50919
54,1,48,16560,17989,57953,75942,44,50933
54,1,49,15882,21044,50431,71475,44,50943
54,1,50,15811,19185,61941,81126,44,50944
55,1,1,12571,22935,81710,104645,45,59407
55,1,2,13147,28949,53325,82274,45,59395
55,1,3,14529,25300,69429,94729,45,59396
55,1,4,12278,30602,66390,96992,45,59416
55,1,5,13354,30373,61490,91863,45,59393
55,1,6,12624,29780,61505,91285,45,59408
55,1,7,13472,27890,65170,93060,45,59390
55,1,8,12058,34114,69307,103421,45,59419
55,1,9,14629,28863,49771,78634,45,59390
55,1,10,13466,25540,72761,98301,45,59390
55,1,11,13027,29704,63925,93629,45,59402
55,1,12,15424,24902,54484,79386,45,59417
55,1,13,13491,29240,66400,95640,45,59393
55,1,14,13490,29710,64241,93951,45,59390
55,1,15,14292,30028,50233,80261,45,59378
55,1,16,12170,27210,75923,103133,45,59420
55,1,17,15106,24913,54016,78929,45,59423
55,1,18,14466,28794,64062,92856,45,59393
55,1,19,15254,30321,50083,80404,45,59423
55,1,20,13436,25886,64582,90468,45,59391
55,1,21,12841,29593,67139,96732,45,59401
55,1,22,15021,25787,58308,84095,45,59425
55,1,23,12985,29130,66642,95772,45,59399
55,1,24,13005,31136,66008,97144,45,59398
55,1,25,12501,29068,79698,108766,45,59412
55,1,26,12218,30855,55639,86494,45,59416
55,1,27,15428,26402,51296,77698,45,59418
55,1,28,14666,25569,64850,90419,45,59391
55,1,29,14876,28372,51419,79791,45,59428
55,1,30,12855,27010,68906,95916,45,59403
55,1,31,15380,24356,63405,87761,45,59418
55,1,32,14811,29709,53254,82963,45,59390
55,1,33,13245,26016,73424,99440,45,59399
55,1,34,10000,32005,78532,110537,45,59406
55,1,35,14829,23963,64476,88439,45,59388
55,1,36,13189,28941,64301,93242,45,59399
55,1,37,12825,29551,65379,94930,45,59403
55,1,38,15224,24751,56786,81537,45,59422
55,1,39,14966,24130,57247,81377,45,59425
55,1,40,15321,25368,55411,80779,45,59420
55,1,41,14350,25552,52584,78136,45,59394
55,1,42,15178,25137,52837,77974,45,59424
55,1,43,10000,27361,74895,102256,45,59406
55,1,44,10000,35630,65480,101110,45,59406
55,1,45,12945,32663,59705,92368,45,59400
55,1,46,13231,28947,61167,90114,45,59394
55,1,47,13074,30159,64360,94519,45,59398
55,1,48,14917,24040,68056,92096,45,59429
55,1,49,13722,29704,64852,94556,45,59387
55,1,50,14672,28224,58724,86948,45,59393
56,1,1,18516,23973,52890,76863,43,42861
56,1,2,19958,22532,37187,59719,43,42877
56,1,3,19356,23022,45731,68753,43,42891
56,1,4,17823,26244,35273,61517,43,42849
56,1,5,18622,23170,44464,67634,43,42861
56,1,6,15266,24955,46256,71211,43,42891
56,1,7,19579,21956,38341,60297,43,42883
56,1,8,17260,25761,45625,71386,43,42857
56,1,9,16612,25807,43934,69741,43,42869
56,1,10,16495,25473,43626,69099,43,42866
56,1,11,17023,25956,52382,78338,43,42868
56,1,12,14547,30614,48808,79422,43,42861
56,1,13,17413,25390,45797,71187,43,42858
56,1,14,17223,26340,45161,71501,43,42865
56,1,15,17514,26299,39975,66274,43,42853
56,1,16,14458,92802,-11147,81655,43,42869
56,1,17,16466,23036,42338,65374,43,42866
56,1,18,15193,27731,38833,66564,43,42886
56,1,19,18316,23658,47906,71564,43,42845
56,1,20,16904,27424,42665,70089,43,42864
56,1,21,16909,25445,47181,72626,43,42861
56,1,22,17032,25749,45454,71203,43,42860
56,1,23,19482,21263,39861,61124,43,42885
56,1,24,16002,25346,57862,83208,43,42878
56,1,25,14944,29200,53023,82223,43,42898
56,1,26,16599,32709,35345,68054,43,42865
56,1,27,16759,23508,50243,73751,43,42861
56,1,28,16353,27091,46394,73485,43,42870
56,1,29,17845,25448,38033,63481,43,42847
56,1,30,18529,24003,36512,60515,43,42861
56,1,31,19616,22242,38924,61166,43,42884
56,1,32,17490,25760,38092,63852,43,42855
56,1,33,19480,21864,43883,65747,43,42885
56,1,34,19894,22728,36259,58987,43,42881
56,1,35,18769,22504,37762,60266,43,42897
56,1,36,19474,22463,37582,60045,43,42891
56,1,37,17574,23534,46978,70512,43,42851
56,1,38,16770,25646,49717,75363,43,42873
56,1,39,14742,26655,49393,76048,43,42861
56,1,40,17770,25797,40379,66176,43,42847
56,1,41,19554,22312,40719,63031,43,42889
56,1,42,16414,25298,46842,72140,43,42871
56,1,43,17272,26459,44366,70825,43,42862
56,1,44,16773,25515,43452,68967,43,42865
56,1,45,18447,26084,35178,61262,43,42862
56,1,46,17866,23062,48519,71581,43,42850
56,1,47,16921,26611,43245,69856,43,42862
56,1,48,18244,21575,56819,78394,43,42847
56,1,49,14810,30431,50117,80548,43,42861
56,1,50,17174,26849,45263,72112,43,42862
57,1,1,13514,23112,74496,97608,48,66337
57,1,2,12928,22548,75281,97829,48,66347
57,1,3,13094,24318,69187,93505,48,66345
57,1,4,15598,19303,59300,78603,48,66360
57,1,5,12816,21782,81164,102946,48,66350
57,1,6,14280,20032,61983,82015,48,66324
57,1,7,12819,21967,73916,95883,48,66354
57,1,8,12757,21176,73041,94217,48,66350
57,1,9,15193,22315,59793,82108,48,66367
57,1,10,13352,21097,75985,97082,48,66337
57,1,11,12655,23643,72508,96151,48,66351
57,1,12,13231,23595,71695,95290,48,66341
57,1,13,12927,23719,71406,95125,48,66349
57,1,14,12308,23822,85816,109638,48,66362
57,1,15,10000,26763,87665,114428,48,66350
57,1,16,15439,21958,57257,79215,48,66365
57,1,17,15403,19969,61046,81015,48,66362
57,1,18,13419,21676,75084,96760,48,66338
57,1,19,15093,18822,74292,93114,48,66373
57,1,20,14251,23415,55890,79305,48,66323
57,1,21,13503,22346,71773,94119,48,66338
57,1,22,13042,23450,73179,96629,48,66348
57,1,23,12218,24515,76848,101363,48,66365
57,1,24,12315,26115,65993,92108,48,66359
57,1,25,15289,20381,64137,84518,48,66365
57,1,26,15057,21593,59793,81386,48,66372
57,1,27,13568,21334,73911,95245,48,66334
57,1,28,15184,19435,69290,88725,48,66369
57,1,29,13773,23508,57457,80965,48,66333
57,1,30,14888,18775,60823,79598,48,66375
57,1,31,12673,22524,85410,107934,48,66353
57,1,32,10000,25713,83758,109471,48,66357
57,1,33,12346,25529,59953,85482,48,66359
57,1,34,15324,19505,62289,81794,48,66367
57,1,35,14648,19192,72434,91626,48,66335
57,1,36,12510,23137,72058,95195,48,66355
57,1,37,14390,25161,54503,79664,48,66342
57,1,38,14919,21044,61470,82514,48,66373
57,1,39,14880,19691,69500,89191,48,66372
57,1,40,12964,24442,60997,85439,48,66346
57,1,41,13688,20958,78527,99485,48,66335
57,1,42,13260,22014,74645,96659,48,66341
57,1,43,12817,24108,69455,93563,48,66351
57,1,44,13882,18744,74781,93525,48,66332
57,1,45,12801,24199,69615,93814,48,66349
57,1,46,13155,23997,72051,96048,48,66342
57,1,47,10000,22272,80726,102998,48,66348
57,1,48,12621,24905,70589,95494,48,66353
57,1,49,13302,22125,78917,101042,48,66342
57,1,50,10000,28033,77047,105080,48,66352
58,1,1,18308,23596,49206,72802,43,42810
58,1,2,16118,25124,39985,65109,43,42840
58,1,3,17823,21015,50089,71104,43,42816
58,1,4,17109,24794,44603,69397,43,42825
58,1,5,17046,25372,47195,72567,43,42826
58,1,6,16939,24859,44344,69203,43,42829
58,1,7,16326,25646,44165,69811,43,42837
58,1,8,18703,22741,38740,61481,43,42865
58,1,9,19442,21054,47084,68138,43,42855
58,1,10,17343,24903,44816,69719,43,42822
58,1,11,16246,24817,45203,70020,43,42838
58,1,12,17430,25448,46478,71926,43,42821
58,1,13,17436,25348,46176,71524,43,42822
58,1,14,16714,24403,51534,75937,43,42832
58,1,15,17724,24805,46805,71610,43,42817
58,1,16,17247,26124,44809,70933,43,42824
58,1,17,16986,25643,54288,79931,43,42828
58,1,18,18170,25769,41484,67253,43,42812
58,1,19,17088,25291,46775,72066,43,42826
58,1,20,19512,24837,32586,57423,43,42854
58,1,21,17526,22792,45156,67948,43,42819
58,1,22,19149,21155,38707,59862,43,42860
58,1,23,20197,21182,37491,58673,43,42845
58,1,24,18146,20459,46980,67439,43,42811
58,1,25,17731,25737,43735,69472,43,42817
58,1,26,18466,25572,36288,61860,43,42829
58,1,27,17148,23399,46213,69612,43,42825
58,1,28,19530,21093,42325,63418,43,42854
58,1,29,17259,25164,38233,63397,43,42823
58,1,30,16412,22182,40490,62672,43,42835
58,1,31,19353,21872,41170,63042,43,42857
58,1,32,17145,24723,45921,70644,43,42824
58,1,33,17400,24726,44377,69103,43,42821
58,1,34,17780,25334,46074,71408,43,42817
58,1,35,16982,26017,42916,68933,43,42827
58,1,36,16111,21028,49042,70070,43,42841
58,1,37,14830,28755,50678,79433,43,42822
58,1,38,17022,25328,37831,63159,43,42826
58,1,39,20091,21626,43464,65090,43,42846
58,1,40,17888,25273,33543,58816,43,42814
58,1,41,19468,21563,45321,66884,43,42855
58,1,42,16992,24446,44696,69142,43,42827
58,1,43,17103,25308,43223,68531,43,42826
58,1,44,17386,25247,43375,68622,43,42822
58,1,45,16686,25256,44383,69639,43,42831
58,1,46,15981,27471,47162,74633,43,42843
58,1,47,20403,20917,43458,64375,43,42842
58,1,48,19059,25677,34964,60641,43,42861
58,1,49,17878,22026,46128,68154,43,42815
58,1,50,16900,25000,44406,69406,43,42829
59,1,1,8211,40618,126428,167046,48,88526
59,1,2,9487,41678,128161,169839,48,88549
59,1,3,7447,36994,112852,149846,48,88578
59,1,4,10000,39860,132523,172383,48,88539
59,1,5,5943,43657,162643,206300,48,88552
59,1,6,5634,46100,141892,187992,48,88587
59,1,7,10000,40639,125472,166111,48,88527
59,1,8,10000,33794,117362,151156,48,88550
59,1,9,10000,39991,125530,165521,48,88541
59,1,10,7039,40461,123366,163827,48,88520
59,1,11,10000,34810,110856,145666,48,88529
59,1,12,7963,34794,116305,151099,48,88528
59,1,13,7213,35383,121262,156645,48,88568
59,1,14,10000,34639,110254,144893,48,88528
59,1,15,7448,35115,114408,149523,48,88566
59,1,16,5664,40566,138400,178966,48,88561
59,1,17,6614,33611,135674,169285,48,88528
59,1,18,8528,46454,125208,171662,48,88519
59,1,19,7654,40337,123303,163640,48,88544
59,1,20,8524,35678,121503,157181,48,88526
59,1,21,10000,40751,131189,171940,48,88547
59,1,22,9132,41540,134410,175950,48,88523
59,1,23,7465,42330,121340,163670,48,88562
59,1,24,7471,35584,108675,144259,48,88562
59,1,25,5792,40299,137255,177554,48,88577
59,1,26,10000,41295,124519,165814,48,88554
59,1,27,5413,45298,164150,209448,48,88541
59,1,28,7411,46929,141855,188784,48,88572
59,1,29,8456,41212,125798,167010,48,88514
59,1,30,6633,41347,133262,174609,48,88528
59,1,31,5834,41580,135362,176942,48,88559
59,1,32,8517,38345,114387,152732,48,88534
59,1,33,7573,35669,138749,174418,48,88551
59,1,34,10000,40685,127647,168332,48,88539
59,1,35,10000,41084,126151,167235,48,88533
59,1,36,7891,41104,145269,186373,48,88551
59,1,37,10000,41736,131677,173413,48,88532
59,1,38,9175,35885,123304,159189,48,88527
59,1,39,8596,40427,119357,159784,48,88519
59,1,40,6990,35263,115215,150478,48,88529
59,1,41,10000,41462,122903,164365,48,88529
59,1,42,10000,35183,108722,143905,48,88535
59,1,43,7952,37228,113842,151070,48,88519
59,1,44,8766,39583,466919,506502,48,88521
59,1,45,7192,51183,140092,191275,48,88557
59,1,46,6794,44169,150465,194634,48,88523
59,1,47,10000,34293,162209,196502,48,88541
59,1,48,5817,46121,143497,189618,48,88578
59,1,49,8226,47155,124255,171410,48,88517
59,1,50,5912,39667,136800,176467,48,88545
60,1,1,22893,13828,38871,52699,44,47358
60,1,2,21327,14481,47504,61985,44,47376
60,1,3,19794,20810,30797,51607,44,47395
60,1,4,20883,15102,38661,53763,44,47381
60,1,5,19629,15581,52032,67613,44,47398
60,1,6,17053,22427,42599,65026,44,47372
60,1,7,23245,13947,38813,52760,44,47356
60,1,8,23379,15245,38373,53618,44,47354
60,1,9,25831,14556,30292,44848,44,47388
60,1,10,22608,13096,39949,53045,44,47362
60,1,11,26418,12244,35024,47268,44,47382
60,1,12,26040,14353,30088,44441,44,47385
60,1,13,23991,13027,39443,52470,44,47408
60,1,14,21988,13943,43746,57689,44,47369
60,1,15,18474,17578,37406,54984,44,47373
60,1,16,22664,12373,40607,52980,44,47361
60,1,17,21589,14345,39667,54012,44,47373
60,1,18,21956,14743,37262,52005,44,47368
60,1,19,17300,15022,44717,59739,44,47368
60,1,20,22705,14106,39719,53825,44,47360
60,1,21,24187,14387,31213,45600,44,47405
60,1,22,25990,12145,31019,43164,44,47386
60,1,23,24334,12433,36673,49106,44,47404
60,1,24,20850,15497,37502,52999,44,47380
60,1,25,21849,14779,31730,46509,44,47370
60,1,26,23538,12022,41291,53313,44,47353
60,1,27,20791,13985,40286,54271,44,47381
60,1,28,26413,12167,30398,42565,44,47382
60,1,29,23512,12256,39744,52000,44,47353
60,1,30,25190,12887,31874,44761,44,47394
60,1,31,22275,13926,39322,53248,44,47365
60,1,32,21853,15588,37671,53259,44,47370
60,1,33,19476,16450,45389,61839,44,47400
60,1,34,19401,16091,39514,55605,44,47400
60,1,35,22978,13661,45519,59180,44,47358
60,1,36,23226,13567,38400,51967,44,47355
60,1,37,22101,14211,34310,48521,44,47366
60,1,38,26367,12449,32625,45074,44,47383
60,1,39,25491,12602,31840,44442,44,47391
60,1,40,22284,14742,37853,52595,44,47364
60,1,41,21961,13754,44103,57857,44,47368
60,1,42,20402,16291,41409,57700,44,47387
60,1,43,21260,14498,39966,54464,44,47376
60,1,44,21976,15155,40351,55506,44,47369
60,1,45,23064,15477,36815,52292,44,47357
60,1,46,25305,12328,33129,45457,44,47393
60,1,47,21283,14479,40718,55197,44,47376
60,1,48,26760,12166,36237,48403,44,47379
60,1,49,27090,14062,29303,43365,44,47376
60,1,50,22036,13660,37848,51508,44,47367
61,1,1,25888,16836,22672,39508,43,42522
61,1,2,30826,13329,24022,37351,43,42538
61,1,3,32438,13010,23180,36190,43,42524
61,1,4,31436,14533,22916,37449,43,42533
61,1,5,30600,13248,24863,38111,43,42540
61,1,6,31027,13103,26127,39230,43,42536
61,1,7,31837,14054,23012,37066,43,42530
61,1,8,31202,14734,22371,37105,43,42535
61,1,9,28362,15437,25257,40694,43,42499
61,1,10,28419,15858,24595,40453,43,42499
61,1,11,31094,13312,24493,37805,43,42536
61,1,12,29410,13398,23263,36661,43,42490
61,1,13,28856,14812,23632,38444,43,42495
61,1,14,30307,14058,23695,37753,43,42542
61,1,15,29901,13262,22956,36218,43,42547
61,1,16,36562,11381,18737,30118,43,42494
61,1,17,32179,11653,24453,36106,43,42527
61,1,18,29437,16194,23175,39369,43,42490
61,1,19,25563,17204,27610,44814,43,42525
61,1,20,37712,12512,18259,30771,43,42547
61,1,21,35059,11201,20130,31331,43,42505
61,1,22,34178,12846,20975,33821,43,42511
61,1,23,31996,15120,22755,37875,43,42528
61,1,24,31411,14671,23777,38448,43,42533
61,1,25,35870,12070,19050,31120,43,42499
61,1,26,31545,14067,22524,36591,43,42532
61,1,27,29954,13449,24381,37830,43,42546
61,1,28,29710,14305,25248,39553,43,42549
61,1,29,30747,13622,23211,36833,43,42539
61,1,30,33150,13635,23987,37622,43,42519
61,1,31,29007,13573,24408,37981,43,42493
61,1,32,34729,13005,18835,31840,43,42507
61,1,33,31732,12133,24141,36274,43,42530
61,1,34,30309,13601,23594,37195,43,42543
61,1,35,30490,14234,22990,37224,43,42541
61,1,36,31531,13601,23987,37588,43,42531
61,1,37,25692,16356,26672,43028,43,42524
61,1,38,25975,17192,26346,43538,43,42521
61,1,39,29283,13500,25373,38873,43,42491
61,1,40,37558,11679,23820,35499,43,42549
61,1,41,32475,12933,24505,37438,43,42524
61,1,42,33380,12410,18716,31126,43,42516
61,1,43,32245,13135,23938,37073,43,42526
61,1,44,37687,11784,19282,31066,43,42548
61,1,45,31513,12983,26050,39033,43,42532
61,1,46,28839,14103,25868,39971,43,42496
61,1,47,35955,11227,19728,30955,43,42499
61,1,48,34820,13006,21001,34007,43,42507
61,1,49,28498,16290,23493,39783,43,42498
61,1,50,29686,14417,22766,37183,43,42488
62,1,1,21261,11069,39167,50236,44,46559
62,1,2,23250,12028,33327,45355,44,46538
62,1,3,24782,10669,40526,51195,44,46582
62,1,4,20682,15193,45071,60264,44,46568
62,1,5,23330,13345,37102,50447,44,46538
62,1,6,24128,12088,36832,48920,44,46589
62,1,7,22788,12321,36340,48661,44,46543
62,1,8,22962,12379,39628,52007,44,46542
62,1,9,23605,12226,37187,49413,44,46596
62,1,10,23841,12047,37677,49724,44,46593
62,1,11,22292,13347,39384,52731,44,46548
62,1,12,20810,15208,38986,54194,44,46566
62,1,13,22856,12421,38525,50946,44,46543
62,1,14,23773,12523,30086,42609,44,46593
62,1,15,25731,11711,36738,48449,44,46572
62,1,16,24625,13525,35764,49289,44,46584
62,1,17,20804,14728,39869,54597,44,46565
62,1,18,24562,12251,36666,48917,44,46584
62,1,19,23772,13053,37943,50996,44,46593
62,1,20,24026,12354,37807,50161,44,46590
62,1,21,26460,12192,43898,56090,44,46565
62,1,22,21189,13515,43250,56765,44,46561
62,1,23,22620,12367,37729,50096,44,46545
62,1,24,23946,12153,37654,49807,44,46591
62,1,25,23601,12090,37435,49525,44,46596
62,1,26,26456,10144,34311,44455,44,46565
62,1,27,22404,12313,38125,50438,44,46547
62,1,28,27715,11226,30742,41968,44,46554
62,1,29,21621,12579,37601,50180,44,46555
62,1,30,24858,14589,29859,44448,44,46581
62,1,31,25620,11717,29973,41690,44,46572
62,1,32,23240,11598,42323,53921,44,46538
62,1,33,24198,12062,38537,50599,44,46588
62,1,34,21655,13437,36155,49592,44,46555
62,1,35,23412,11966,38366,50332,44,46537
62,1,36,24240,12339,37459,49798,44,46588
62,1,37,24080,12893,31690,44583,44,46590
62,1,38,27912,11730,30137,41867,44,46551
62,1,39,25923,10292,40544,50836,44,46570
62,1,40,20805,15308,54018,69326,44,46567
62,1,41,19113,16456,44287,60743,44,46588
62,1,42,23414,12961,37138,50099,44,46537
62,1,43,22690,12583,36963,49546,44,46544
62,1,44,21675,13854,35020,48874,44,46555
62,1,45,27450,10656,37873,48529,44,46556
62,1,46,22527,13643,37446,51089,44,46546
62,1,47,27478,11533,29969,41502,44,46555
62,1,48,27712,11265,30486,41751,44,46553
62,1,49,23258,12485,45534,58019,44,46539
62,1,50,22507,12410,37704,50114,44,46546
63,1,1,12826,35354,76453,111807,44,47300
63,1,2,10000,37580,68732,106312,44,47301
63,1,3,10000,36966,65418,102384,44,47297
63,1,4,10000,37348,66654,104002,44,47299
63,1,5,10000,37906,63881,101787,44,47301
63,1,6,10000,37041,67958,104999,44,47302
63,1,7,10000,36777,66706,103483,44,47300
63,1,8,11096,40113,74628,114741,44,47274
63,1,9,10000,42149,75545,117694,44,47299
63,1,10,10000,42344,65216,107560,44,47299
63,1,11,10000,37608,66318,103926,44,47301
63,1,12,13282,32681,57396,90077,44,47291
63,1,13,13093,32396,65867,98263,44,47298
63,1,14,10000,35761,67315,103076,44,47297
63,1,15,10000,36973,66166,103139,44,47298
63,1,16,10000,36071,70280,106351,44,47300
63,1,17,10000,341251,-232823,108428,44,47302
63,1,18,10000,48703,51319,100022,44,47301
63,1,19,9481,37023,78453,115476,44,47314
63,1,20,10000,40311,88639,128950,44,47302
63,1,21,12284,38868,64455,103323,44,47309
63,1,22,10000,36926,67679,104605,44,47299
63,1,23,11611,35545,70311,105856,44,47283
63,1,24,13152,38447,49964,88411,44,47290
63,1,25,13711,31389,55847,87236,44,47284
63,1,26,13624,31262,60597,91859,44,47286
63,1,27,11128,33294,77977,111271,44,47272
63,1,28,10000,43353,74898,118251,44,47299
63,1,29,8738,64415,88774,153189,44,47293
63,1,30,7453,48966,100417,149383,44,47308
63,1,31,10000,42620,64879,107499,44,47302
63,1,32,10000,36874,71958,108832,44,47302
63,1,33,12111,36423,68490,104913,44,47315
63,1,34,10000,36559,66759,103318,44,47299
63,1,35,12513,36335,55120,91455,44,47306
63,1,36,12122,32241,83145,115386,44,47317
63,1,37,11746,37059,65794,102853,44,47281
63,1,38,10000,36196,66039,102235,44,47299
63,1,39,10000,37942,72186,110128,44,47303
63,1,40,11199,39486,68410,107896,44,47273
63,1,41,13354,32409,63177,95586,44,47288
63,1,42,11377,37917,67031,104948,44,47289
63,1,43,10000,38481,62695,101176,44,47302
63,1,44,13894,31945,68603,100548,44,47280
63,1,45,10000,38122,63086,101208,44,47298
63,1,46,12003,36604,56163,92767,44,47319
63,1,47,12370,31535,73797,105332,44,47311
63,1,48,10000,37349,66726,104075,44,47301
63,1,49,12807,36956,56313,93269,44,47299
63,1,50,10000,36823,67028,103851,44,47301
64,1,1,16663,20384,42116,62500,43,42768
64,1,2,19705,23075,39394,62469,43,42789
64,1,3,20154,22421,33804,56225,43,42779
64,1,4,18475,19598,37707,57305,43,42762
64,1,5,18715,22471,38932,61403,43,42802
64,1,6,18996,22677,38341,61018,43,42794
64,1,7,19974,22918,40078,62996,43,42782
64,1,8,20215,22464,37337,59801,43,42779
64,1,9,18385,24196,31827,56023,43,42745
64,1,10,19032,19541,44046,63587,43,42797
64,1,11,20156,21264,38501,59765,43,42785
64,1,12,19683,22484,38135,60619,43,42788
64,1,13,19407,22174,38262,60436,43,42795
64,1,14,20161,20894,39418,60312,43,42780
64,1,15,21945,22173,29924,52097,43,42760
64,1,16,21819,18922,31600,50522,43,42756
64,1,17,21340,19481,40262,59743,43,42767
64,1,18,20110,22234,38987,61221,43,42783
64,1,19,18190,25900,45329,71229,43,42751
64,1,20,19927,22292,36601,58893,43,42783
64,1,21,20100,22228,32864,55092,43,42777
64,1,22,20485,21392,38721,60113,43,42778
64,1,23,20065,22367,38808,61175,43,42781
64,1,24,20077,20706,41280,61986,43,42782
64,1,25,22515,19023,33778,52801,43,42754
64,1,26,19588,22015,37914,59929,43,42786
64,1,27,20060,22164,38354,60518,43,42782
64,1,28,15864,26494,42184,68678,43,42786
64,1,29,20494,21227,38017,59244,43,42774
64,1,30,19754,22013,40108,62121,43,42791
64,1,31,19219,23061,38370,61431,43,42798
64,1,32,19149,22966,45131,68097,43,42802
64,1,33,20070,20530,39058,59588,43,42781
64,1,34,20407,21606,39549,61155,43,42781
64,1,35,19956,22609,36048,58657,43,42782
64,1,36,19730,21026,39993,61019,43,42788
64,1,37,19203,22996,42576,65572,43,42798
64,1,38,21297,21735,40548,62283,43,42766
64,1,39,19258,26633,37478,64111,43,42791
64,1,40,18820,22429,40248,62677,43,42799
64,1,41,17157,24170,36440,60610,43,42763
64,1,42,19790,22479,38750,61229,43,42782
64,1,43,19567,22683,38185,60868,43,42789
64,1,44,19784,22228,38762,60990,43,42788
64,1,45,18662,21524,32556,54080,43,42768
64,1,46,22465,19568,31300,50868,43,42752
64,1,47,21240,18849,45277,64126,43,42768
64,1,48,18216,24513,39259,63772,43,42750
64,1,49,20476,21624,38058,59682,43,42773
64,1,50,20366,22148,37569,59717,43,42778
65,1,1,20491,24790,40679,65469,43,42777
65,1,2,19033,23259,34418,57677,43,42796
65,1,3,19916,19438,43667,63105,43,42785
65,1,4,19790,24505,39292,63797,43,42785
65,1,5,18637,23359,38836,62195,43,42762
65,1,6,19854,22135,37667,59802,43,42786
65,1,7,20964,22009,37528,59537,43,42772
65,1,8,20890,21021,36039,57060,43,42772
65,1,9,19402,22962,33549,56511,43,42790
65,1,10,21216,20801,37721,58522,43,42769
65,1,11,18818,24083,40760,64843,43,42799
65,1,12,20886,22617,32411,55028,43,42772
65,1,13,18903,21791,41450,63241,43,42798
65,1,14,18458,23952,39964,63916,43,42764
65,1,15,17918,23350,42077,65427,43,42750
65,1,16,17209,27093,42482,69575,43,42760
65,1,17,19177,25252,37710,62962,43,42795
65,1,18,18573,23242,43136,66378,43,42763
65,1,19,18150,24196,38664,62860,43,42748
65,1,20,20172,22680,40968,63648,43,42782
65,1,21,19609,23683,37993,61676,43,42788
65,1,22,18828,23520,38025,61545,43,42799
65,1,23,18062,23132,40079,63211,43,42748
65,1,24,15942,24057,42964,67021,43,42779
65,1,25,18543,23868,40041,63909,43,42763
65,1,26,17814,23531,48176,71707,43,42753
65,1,27,20641,20793,34066,54859,43,42775
65,1,28,21477,21185,35769,56954,43,42765
65,1,29,18254,23525,41427,64952,43,42746
65,1,30,18834,23486,40101,63587,43,42800
65,1,31,18284,23942,41281,65223,43,42746
65,1,32,18560,24853,40420,65273,43,42763
65,1,33,22072,19323,39391,58714,43,42759
65,1,34,18729,23174,40165,63339,43,42801
65,1,35,17493,23916,44107,68023,43,42756
65,1,36,18637,24706,41369,66075,43,42762
65,1,37,19450,23519,41012,64531,43,42791
65,1,38,19318,23413,40174,63587,43,42792
65,1,39,21025,20968,34311,55279,43,42770
65,1,40,18916,22778,43001,65779,43,42799
65,1,41,19202,24182,39253,63435,43,42794
65,1,42,18736,27037,35912,62949,43,42801
65,1,43,19033,23749,34029,57778,43,42796
65,1,44,21240,20184,38046,58230,43,42767
65,1,45,19172,23386,33473,56859,43,42794
65,1,46,19129,23723,37468,61191,43,42796
65,1,47,20167,23348,31592,54940,43,42781
65,1,48,20060,19963,35244,55207,43,42782
65,1,49,19102,22241,40732,62973,43,42795
65,1,50,18978,22003,43495,65498,43,42797
66,1,1,16995,23838,46267,70105,44,45484
66,1,2,16420,21421,54403,75824,44,45492
66,1,3,17266,23046,43638,66684,44,45481
66,1,4,13936,23079,62128,85207,44,45472
66,1,5,14785,26763,51447,78210,44,45479
66,1,6,17498,19916,56118,76034,44,45478
66,1,7,16173,23228,43761,66989,44,45496
66,1,8,15834,20758,67692,88450,44,45502
66,1,9,18022,20204,45276,65480,44,45470
66,1,10,17641,21322,47137,68459,44,45475
66,1,11,14228,23542,53713,77255,44,45467
66,1,12,16638,19761,58962,78723,44,45489
66,1,13,14992,26016,70010,96026,44,45517
66,1,14,16567,21522,54434,75956,44,45491
66,1,15,15340,23669,56355,80024,44,45510
66,1,16,13982,24843,58024,82867,44,45472
66,1,17,16521,24351,55629,79980,44,45491
66,1,18,14658,24248,54736,78984,44,45481
66,1,19,15776,24260,52951,77211,44,45503
66,1,20,18270,19569,54877,74446,44,45467
66,1,21,14460,28464,50120,78584,44,45485
66,1,22,14082,26013,56336,82349,44,45470
66,1,23,14593,25365,54205,79570,44,45483
66,1,24,15238,25019,52008,77027,44,45511
66,1,25,15046,26713,52212,78925,44,45515
66,1,26,16218,24765,52139,76904,44,45496
66,1,27,15583,24351,53851,78202,44,45506
66,1,28,15643,23573,55194,78767,44,45505
66,1,29,15014,24230,54704,78934,44,45515
66,1,30,16485,24167,40679,64846,44,45491
66,1,31,16114,21795,53825,75620,44,45497
66,1,32,16803,24100,50379,74479,44,45487
66,1,33,14433,24399,75847,100246,44,45488
66,1,34,13114,30314,56150,86464,44,45486
66,1,35,15540,23774,52303,76077,44,45506
66,1,36,14696,24906,54927,79833,44,45481
66,1,37,15984,24162,53581,77743,44,45499
66,1,38,15963,25060,41958,67018,44,45499
66,1,39,16785,20553,56167,76720,44,45487
66,1,40,16514,23249,51598,74847,44,45491
66,1,41,15962,20537,59427,79964,44,45499
66,1,42,12314,28194,56030,84224,44,45503
66,1,43,17700,20104,47039,67143,44,45474
66,1,44,15408,23100,56912,80012,44,45509
66,1,45,15907,22880,52299,75179,44,45501
66,1,46,15973,24737,51572,76309,44,45499
66,1,47,16455,24441,57963,82404,44,45492
66,1,48,17926,20043,53040,73083,44,45472
66,1,49,18058,325133,-240994,84139,44,45470
66,1,50,13062,30955,79139,110094,44,45488
67,1,1,6972,46534,121713,168247,47,91873
67,1,2,6823,40418,110743,151161,47,91881
67,1,3,6848,46079,135598,181677,47,91879
67,1,4,10000,46449,125987,172436,47,91870
67,1,5,7671,45820,130972,176792,47,91890
67,1,6,7207,46958,131468,178426,47,91911
67,1,7,6572,50728,140424,191152,47,91900
67,1,8,7197,55762,234796,290558,47,91933
67,1,9,10000,47311,137114,184425,47,91879
67,1,10,8228,47734,134483,182217,47,91887
67,1,11,8774,48469,123206,171675,47,91880
67,1,12,7880,45758,130172,175930,47,91876
67,1,13,10000,40352,118128,158480,47,91888
67,1,14,6778,47645,126460,174105,47,91873
67,1,15,10000,47031,122510,169541,47,91874
67,1,16,7924,46347,107851,154198,47,91873
67,1,17,10000,40838,140294,181132,47,91880
67,1,18,5961,53827,148314,202141,47,91901
67,1,19,8478,51471,126405,177876,47,91883
67,1,20,8738,46131,121102,167233,47,91892
67,1,21,10000,41791,109377,151168,47,91889
67,1,22,8834,39968,108415,148383,47,91875
67,1,23,10000,43613,131373,174986,47,91903
67,1,24,10000,46869,136651,183520,47,91883
67,1,25,9514,47898,122070,169968,47,91901
67,1,26,7430,48037,124411,172448,47,91902
67,1,27,8182,43129,124096,167225,47,91892
67,1,28,8224,48433,123424,171857,47,91867
67,1,29,7891,46379,139724,186103,47,91917
67,1,30,5950,47770,127163,174933,47,91883
67,1,31,5918,48239,135243,183482,47,91898
67,1,32,7668,47177,130230,177407,47,91892
67,1,33,9700,46621,120727,167348,47,91897
67,1,34,7158,45674,127663,173337,47,91877
67,1,35,8762,47617,132209,179826,47,91908
67,1,36,7939,46474,133399,179873,47,91898
67,1,37,7672,46966,128022,174988,47,91917
67,1,38,5916,47510,142323,189833,47,91934
67,1,39,7158,48180,127507,175687,47,91877
67,1,40,7204,52524,130711,183235,47,91910
67,1,41,9166,47399,128604,176003,47,91883
67,1,42,6452,47513,127223,174736,47,91910
67,1,43,7347,45830,126713,172543,47,91923
67,1,44,7159,47007,151091,198098,47,91875
67,1,45,8797,48219,119833,168052,47,91878
67,1,46,10000,41917,112379,154296,47,91874
67,1,47,7446,46859,131000,177859,47,91904
67,1,48,10000,48292,121090,169382,47,91888
67,1,49,10000,43330,119517,162847,47,91885
67,1,50,9508,49551,122724,172275,47,91900
68,1,1,15590,27525,46768,74293,43,43086
68,1,2,14019,33363,56552,89915,43,43051
68,1,3,13766,34260,50446,84706,43,43057
68,1,4,13584,33371,55006,88377,43,43061
68,1,5,13600,33552,55569,89121,43,43061
68,1,6,15151,32538,42802,75340,43,43094
68,1,7,15553,29460,52300,81760,43,43085
68,1,8,14788,32303,52765,85068,43,43059
68,1,9,14185,34480,55203,89683,43,43052
68,1,10,14342,35844,39752,75596,43,43067
68,1,11,14083,32989,53134,86123,43,43051
68,1,12,13254,33860,55006,88866,43,43066
68,1,13,13827,33694,53583,87277,43,43055
68,1,14,13434,34764,54700,89464,43,43061
68,1,15,14026,34327,53406,87733,43,43052
68,1,16,13914,34211,60265,94476,43,43053
68,1,17,12909,37558,52659,90217,43,43074
68,1,18,13582,33574,54836,88410,43,43059
68,1,19,13933,34115,48256,82371,43,43054
68,1,20,15338,29748,50663,80411,43,43092
68,1,21,14074,33354,53391,86745,43,43051
68,1,22,13626,33901,54555,88456,43,43058
68,1,23,13054,34564,56389,90953,43,43069
68,1,24,14050,34261,52730,86991,43,43052
68,1,25,14157,34028,53915,87943,43,43049
68,1,26,12330,35310,54225,89535,43,43084
68,1,27,15060,32657,44725,77382,43,43097
68,1,28,13569,33485,57933,91418,43,43060
68,1,29,15610,28069,47277,75346,43,43086
68,1,30,15920,28581,56163,84744,43,43081
68,1,31,13249,35780,51717,87497,43,43064
68,1,32,13832,33487,55145,88632,43,43056
68,1,33,12768,34225,59648,93873,43,43075
68,1,34,15656,28630,60683,89313,43,43083
68,1,35,14929,35861,41277,77138,43,43099
68,1,36,16551,29316,45302,74618,43,43070
68,1,37,14116,31082,58971,90053,43,43050
68,1,38,13951,33833,56104,89937,43,43054
68,1,39,14156,34509,41575,76084,43,43049
68,1,40,15198,30203,57466,87669,43,43096
68,1,41,13873,34629,53446,88075,43,43055
68,1,42,16165,32352,43166,75518,43,43074
68,1,43,13754,32658,54023,86681,43,43055
68,1,44,10176,35450,69954,105404,43,43072
68,1,45,13275,39095,54727,93822,43,43066
68,1,46,15136,35253,39962,75215,43,43091
68,1,47,14311,30628,57008,87636,43,43047
68,1,48,14348,33326,54280,87606,43,43068
68,1,49,13716,34178,51750,85928,43,43056
68,1,50,14252,32682,53642,86324,43,43049
69,1,1,13521,29383,73136,102519,44,52635
69,1,2,10000,37855,72137,109992,44,52647
69,1,3,11040,34125,72445,106570,44,52623
69,1,4,10000,34372,74889,109261,44,52651
69,1,5,10000,34665,72125,106790,44,52645
69,1,6,10000,39175,73352,112527,44,52649
69,1,7,10000,36754,70818,107572,44,52651
69,1,8,10000,34570,73883,108453,44,52650
69,1,9,12470,34323,58584,92907,44,52649
69,1,10,10000,31590,69048,100638,44,52645
69,1,11,10000,33729,72796,106525,44,52654
69,1,12,10000,39302,66817,106119,44,52641
69,1,13,12460,34318,63134,97452,44,52654
69,1,14,10017,33827,87000,120827,44,52654
69,1,15,10000,37103,69132,106235,44,52651
69,1,16,10000,34011,68699,102710,44,52653
69,1,17,11823,33714,61435,95149,44,52668
69,1,18,10000,29617,72443,102060,44,52642
69,1,19,10000,35510,71684,107194,44,52645
69,1,20,11605,34312,75044,109356,44,52635
69,1,21,10000,34357,69456,103813,44,52656
69,1,22,10000,33559,67095,100654,44,52647
69,1,23,13208,30290,69370,99660,44,52634
69,1,24,10000,34868,75502,110370,44,52651
69,1,25,10000,36237,70317,106554,44,52650
69,1,26,12925,30502,63252,93754,44,52639
69,1,27,12684,29443,76824,106267,44,52647
69,1,28,10000,33811,69523,103334,44,52644
69,1,29,10000,34498,73115,107613,44,52649
69,1,30,10000,34437,68843,103280,44,52653
69,1,31,10000,33634,74168,107802,44,52652
69,1,32,9157,34119,89742,123861,44,52629
69,1,33,10000,34408,75216,109624,44,52650
69,1,34,13173,33228,58944,92172,44,52639
69,1,35,12873,29843,63970,93813,44,52639
69,1,36,8796,34704,87223,121927,44,52641
69,1,37,10000,38588,87760,126348,44,52655
69,1,38,10881,38777,72804,111581,44,52629
69,1,39,10000,37305,68587,105892,44,52641
69,1,40,12693,28931,67261,96192,44,52653
69,1,41,12403,29402,77065,106467,44,52650
69,1,42,12757,29097,64324,93421,44,52643
69,1,43,12922,29707,73706,103413,44,52644
69,1,44,10000,35326,69859,105185,44,52648
69,1,45,10000,34146,77924,112070,44,52646
69,1,46,10000,38839,73246,112085,44,52650
69,1,47,10000,34967,74870,109837,44,52650
69,1,48,10000,34537,70969,105506,44,52648
69,1,49,10000,34210,72053,106263,44,52647
69,1,50,13029,32979,59949,92928,44,52639
70,1,1,26628,12735,25639,38374,43,42498
70,1,2,31064,13023,19673,32696,43,42520
70,1,3,29913,11130,26941,38071,43,42530
70,1,4,31066,13310,23604,36914,43,42520
70,1,5,28113,14504,28566,43070,43,42485
70,1,6,29029,14383,25768,40151,43,42477
70,1,7,27238,12773,26261,39034,43,42492
70,1,8,34345,11333,19995,31328,43,42493
70,1,9,30777,12528,25950,38478,43,42523
70,1,10,31522,12957,24812,37769,43,42516
70,1,11,32704,12272,20753,33025,43,42506
70,1,12,30934,11438,24951,36389,43,42521
70,1,13,29644,12981,25636,38617,43,42472
70,1,14,33232,11706,20709,32415,43,42502
70,1,15,31062,12680,25267,37947,43,42520
70,1,16,37251,12005,23249,35254,43,42475
70,1,17,30888,12092,25783,37875,43,42521
70,1,18,34485,10837,21811,32648,43,42493
70,1,19,30060,13546,24540,38086,43,42529
70,1,20,31116,12897,25946,38843,43,42519
70,1,21,29002,13020,24540,37560,43,42478
70,1,22,31048,13197,24012,37209,43,42520
70,1,23,28076,13827,30093,43920,43,42486
70,1,24,25867,16155,27371,43526,43,42506
70,1,25,30194,13039,26197,39236,43,42528
70,1,26,28668,13082,26839,39921,43,42480
70,1,27,31812,12942,24543,37485,43,42513
70,1,28,33480,12884,24844,37728,43,42500
70,1,29,29835,12778,25669,38447,43,42531
70,1,30,30576,14002,24130,38132,43,42524
70,1,31,29737,12621,26490,39111,43,42533
70,1,32,27093,56828,-1512,55316,43,42495
70,1,33,31956,13258,20114,33372,43,42512
70,1,34,27373,12008,40559,52567,43,42493
70,1,35,27048,19693,20437,40130,43,42493
70,1,36,38041,12720,17938,30658,43,42528
70,1,37,29850,12487,25317,37804,43,42531
70,1,38,34518,10562,25635,36197,43,42492
70,1,39,29892,12559,25153,37712,43,42530
70,1,40,23822,15363,34088,49451,43,42528
70,1,41,23372,18780,31487,50267,43,42474
70,1,42,22416,19627,29928,49555,43,42483
70,1,43,24416,15935,29988,45923,43,42521
70,1,44,31360,11476,26233,37709,43,42517
70,1,45,29868,13222,25173,38395,43,42531
70,1,46,30624,12964,25353,38317,43,42523
70,1,47,30367,12745,24608,37353,43,42526
70,1,48,26574,14059,29683,43742,43,42499
70,1,49,29530,13683,26822,40505,43,42473
70,1,50,31915,12931,26256,39187,43,42513
71,1,1,20432,18630,42193,60823,44,47526
71,1,2,21708,16107,35439,51546,44,47509
71,1,3,22248,15919,35795,51714,44,47505
71,1,4,21780,16344,41994,58338,44,47509
71,1,5,19792,19359,44231,63590,44,47534
71,1,6,19299,18354,44839,63193,44,47542
71,1,7,16420,20789,52558,73347,44,47522
71,1,8,17328,19729,45914,65643,44,47509
71,1,9,19167,18512,45329,63841,44,47544
71,1,10,19602,19104,48354,67458,44,47538
71,1,11,18877,17990,44328,62318,44,47547
71,1,12,19180,19863,36663,56526,44,47542
71,1,13,16489,15728,50276,66004,44,47519
71,1,14,19320,17888,44245,62133,44,47540
71,1,15,18163,19721,46129,65850,44,47496
71,1,16,17271,20733,47181,67914,44,47508
71,1,17,19575,18327,45830,64157,44,47538
71,1,18,18090,19278,43965,63243,44,47499
71,1,19,18680,21570,42685,64255,44,47508
71,1,20,21597,19003,33563,52566,44,47512
71,1,21,20678,16115,43081,59196,44,47521
71,1,22,19485,19658,45241,64899,44,47540
71,1,23,18942,19447,44402,63849,44,47547
71,1,24,18943,19296,42659,61955,44,47545
71,1,25,22238,16108,40253,56361,44,47504
71,1,26,16508,22676,49254,71930,44,47520
71,1,27,17043,23004,43674,66678,44,47512
71,1,28,19422,19016,44501,63517,44,47538
71,1,29,18093,19451,42607,62058,44,47497
71,1,30,19826,18610,44254,62864,44,47536
71,1,31,17776,21838,43903,65741,44,47501
71,1,32,22072,15677,38651,54328,44,47507
71,1,33,19352,18834,45102,63936,44,47540
71,1,34,20996,18891,35718,54609,44,47519
71,1,35,19520,17529,49326,66855,44,47538
71,1,36,21541,19978,31642,51620,44,47511
71,1,37,19861,17449,45862,63311,44,47534
71,1,38,23109,15653,35782,51435,44,47494
71,1,39,22944,16011,40438,56449,44,47496
71,1,40,18322,19554,44778,64332,44,47494
71,1,41,22099,17899,37653,55552,44,47506
71,1,42,19903,16800,46097,62897,44,47532
71,1,43,20563,18491,42795,61286,44,47523
71,1,44,18264,19111,52352,71463,44,47496
71,1,45,16466,20312,46223,66535,44,47520
71,1,46,19800,18004,44753,62757,44,47535
71,1,47,18624,19773,50004,69777,44,47510
71,1,48,17830,19960,43518,63478,44,47502
71,1,49,19021,19146,43884,63030,44,47544
71,1,50,19280,19286,44210,63496,44,47541
72,1,1,5970,61004,124222,185226,45,70879
72,1,2,10000,47036,124424,171460,45,70856
72,1,3,7414,46125,121171,167296,45,70880
72,1,4,7006,44877,114203,159080,45,70875
72,1,5,10000,38177,108028,146205,45,70847
72,1,6,7444,45431,123190,168621,45,70866
72,1,7,7210,44411,122536,166947,45,70881
72,1,8,7208,43702,122047,165749,45,70864
72,1,9,7891,44022,122253,166275,45,70849
72,1,10,7176,44750,131819,176569,45,70883
72,1,11,7922,45109,116838,161947,45,70871
72,1,12,6523,43913,129215,173128,45,70858
72,1,13,5942,46271,153725,199996,45,70890
72,1,14,6962,52448,126993,179441,45,70863
72,1,15,10000,48368,119774,168142,45,70851
72,1,16,7630,44277,120936,165213,45,70881
72,1,17,8193,43475,105612,149087,45,70848
72,1,18,8457,38671,123830,162501,45,70849
72,1,19,8209,45707,100861,146568,45,70862
72,1,20,8942,38098,123953,162051,45,70850
72,1,21,7398,43738,147711,191449,45,70896
72,1,22,10000,45699,124279,169978,45,70850
72,1,23,8444,46980,131467,178447,45,70850
72,1,24,9852,45904,116563,162467,45,70858
72,1,25,10000,44207,122623,166830,45,70868
72,1,26,5912,43331,155608,198939,45,70874
72,1,27,10000,46289,114506,160795,45,70848
72,1,28,10000,37783,106461,144244,45,70835
72,1,29,10000,48126,116033,164159,45,70831
72,1,30,7440,44044,119577,163621,45,70855
72,1,31,8150,38111,118740,156851,45,70841
72,1,32,7244,44482,130274,174756,45,70902
72,1,33,7416,44142,123524,167666,45,70865
72,1,34,6610,57779,137625,195404,45,70845
72,1,35,8223,49989,123511,173500,45,70876
72,1,36,9493,43274,116166,159440,45,70870
72,1,37,7992,43292,127904,171196,45,70860
72,1,38,7215,44620,124440,169060,45,70885
72,1,39,8497,43658,117978,161636,45,70833
72,1,40,6999,44178,125736,169914,45,70848
72,1,41,6813,44928,124838,169766,45,70870
72,1,42,9968,44982,119196,164178,45,70861
72,1,43,7203,44519,119264,163783,45,70875
72,1,44,7693,44954,110914,155868,45,70872
72,1,45,7828,41205,112620,153825,45,70869
72,1,46,5811,40026,132908,172934,45,70895
72,1,47,8468,44530,104473,149003,45,70836
72,1,48,6608,38655,127255,165910,45,70835
72,1,49,7927,44474,121699,166173,45,70839
72,1,50,6278,44057,128852,172909,45,70861
73,1,1,21871,19799,34828,54627,44,50967
73,1,2,20841,21657,42208,63865,44,50980
73,1,3,17674,26314,33877,60191,44,50961
73,1,4,21276,19450,38424,57874,44,50974
73,1,5,17085,24129,50011,74140,44,50971
73,1,6,17038,25987,44954,70941,44,50971
73,1,7,20065,19110,47044,66154,44,50990
73,1,8,18136,23074,49220,72294,44,50955
73,1,9,18369,23714,44340,68054,44,50953
73,1,10,17890,24610,43675,68285,44,50959
73,1,11,17260,24291,45743,70034,44,50968
73,1,12,17647,22544,41238,63782,44,50963
73,1,13,20452,20330,41422,61752,44,50985
73,1,14,17847,24902,46421,71323,44,50961
73,1,15,17598,24216,44598,68814,44,50964
73,1,16,18163,22426,47000,69426,44,50956
73,1,17,20754,19066,41767,60833,44,50980
73,1,18,17450,23748,43246,66994,44,50966
73,1,19,18489,22173,54630,76803,44,50972
73,1,20,18699,24471,45389,69860,44,51011
73,1,21,18675,24083,43210,67293,44,50969
73,1,22,18002,23731,44631,68362,44,50956
73,1,23,15842,23776,56303,80079,44,50990
73,1,24,15626,27916,43147,71063,44,50993
73,1,25,16813,22945,46896,69841,44,50972
73,1,26,18510,22119,43983,66102,44,50971
73,1,27,19012,18990,48458,67448,44,51002
73,1,28,19622,23224,33504,56728,44,50994
73,1,29,20565,20196,38947,59143,44,50983
73,1,30,18618,20779,47384,68163,44,50969
73,1,31,16719,24068,44790,68858,44,50973
73,1,32,16018,25147,47315,72462,44,50989
73,1,33,16646,25460,40492,65952,44,50976
73,1,34,18583,23424,41997,65421,44,50970
73,1,35,18054,23816,44444,68260,44,50955
73,1,36,17827,24239,42420,66659,44,50958
73,1,37,17742,25218,40565,65783,44,50960
73,1,38,17563,24295,44007,68302,44,50963
73,1,39,19140,23566,42821,66387,44,51002
73,1,40,17636,23916,45105,69021,44,50963
73,1,41,17388,24458,45376,69834,44,50966
73,1,42,17028,23976,51164,75140,44,50969
73,1,43,16269,27407,45235,72642,44,50983
73,1,44,17204,22595,45924,68519,44,50966
73,1,45,21218,19110,42261,61371,44,50976
73,1,46,17578,23197,45355,68552,44,50963
73,1,47,18226,23470,42563,66033,44,50954
73,1,48,18022,22913,46535,69448,44,50957
73,1,49,18117,24157,42755,66912,44,50954
73,1,50,17545,23318,44415,67733,44,50965
74,1,1,40335,10883,17574,28457,43,42440
74,1,2,38974,9409,19135,28544,43,42450
74,1,3,37450,13976,16279,30255,43,42461
74,1,4,35330,12774,15559,28333,43,42415
74,1,5,47200,9688,13414,23102,43,42461
74,1,6,39998,9592,19501,29093,43,42442
74,1,7,35506,13195,17630,30825,43,42414
74,1,8,45852,9466,15816,25282,43,42408
74,1,9,39139,11050,17971,29021,43,42449
74,1,10,36472,52394,-14886,37508,43,42408
74,1,11,35728,12207,20666,32873,43,42411
74,1,12,26917,14764,23577,38341,43,42424
74,1,13,41768,8878,15623,24501,43,42431
74,1,14,39301,11131,19143,30274,43,42447
74,1,15,32920,11585,19673,31258,43,42431
74,1,16,41502,8933,20340,29273,43,42433
74,1,17,29799,12560,27307,39867,43,42460
74,1,18,32120,13233,19812,33045,43,42439
74,1,19,28324,14898,25661,40559,43,42412
74,1,20,30490,14546,22846,37392,43,42454
74,1,21,39283,14429,16058,30487,43,42449
74,1,22,42968,9356,19287,28643,43,42425
74,1,23,37830,11468,18289,29757,43,42458
74,1,24,36321,11955,18011,29966,43,42408
74,1,25,33148,12539,22300,34839,43,42431
74,1,26,33136,13513,17798,31311,43,42431
74,1,27,33462,11753,18295,30048,43,42428
74,1,28,36675,13765,17372,31137,43,42406
74,1,29,38728,11834,14753,26587,43,42452
74,1,30,39165,9765,19465,29230,43,42448
74,1,31,40394,11309,18688,29997,43,42441
74,1,32,39057,10753,18209,28962,43,42449
74,1,33,35684,11090,18934,30024,43,42412
74,1,34,34480,12482,18983,31465,43,42422
74,1,35,36792,11834,19029,30863,43,42405
74,1,36,37286,11157,19036,30193,43,42402
74,1,37,37106,11016,18018,29034,43,42403
74,1,38,35815,13327,16923,30250,43,42412
74,1,39,37150,11231,19440,30671,43,42403
74,1,40,36847,11447,18131,29578,43,42405
74,1,41,37377,11243,19118,30361,43,42461
74,1,42,35398,11924,19284,31208,43,42414
74,1,43,39620,11687,17239,28926,43,42445
74,1,44,38895,11602,18458,30060,43,42451
74,1,45,34509,12702,17417,30119,43,42420
74,1,46,35415,10894,19192,30086,43,42414
74,1,47,36643,11207,18050,29257,43,42406
74,1,48,36676,12867,16739,29606,43,42405
74,1,49,38091,11108,18414,29522,43,42456
74,1,50,38104,11405,18078,29483,43,42457
75,1,1,15876,22939,61283,84222,46,61227
75,1,2,17149,19780,54293,74073,46,61208
75,1,3,15674,23634,58313,81947,46,61234
75,1,4,15387,23650,56669,80319,46,61238
75,1,5,14691,22723,62220,84943,46,61207
75,1,6,15855,21508,57645,79153,46,61229
75,1,7,15177,23967,57449,81416,46,61238
75,1,8,15297,23707,50905,74612,46,61238
75,1,9,15447,18419,63767,82186,46,61240
75,1,10,17290,22215,44155,66370,46,61208
75,1,11,14120,21235,72724,93959,46,61205
75,1,12,16132,22664,55513,78177,46,61228
75,1,13,15326,22915,60406,83321,46,61247
75,1,14,15444,22534,55431,77965,46,61235
75,1,15,15058,22842,53878,76720,46,61242
75,1,16,13542,24699,58708,83407,46,61211
75,1,17,15434,23421,53493,76914,46,61237
75,1,18,16128,23226,55784,79010,46,61227
75,1,19,15351,23501,60472,83973,46,61238
75,1,20,15034,23394,62293,85687,46,61243
75,1,21,13388,26056,59830,85886,46,61214
75,1,22,13852,22995,62723,85718,46,61206
75,1,23,14650,23151,56724,79875,46,61208
75,1,24,15394,23278,59733,83011,46,61240
75,1,25,15433,22932,57914,80846,46,61240
75,1,26,17853,19336,53698,73034,46,61196
75,1,27,15673,22116,59962,82078,46,61236
75,1,28,15213,23145,60239,83384,46,61245
75,1,29,15152,21825,59122,80947,46,61242
75,1,30,13386,26750,62705,89455,46,61212
75,1,31,14430,25968,54601,80569,46,61215
75,1,32,15201,23324,47044,70368,46,61238
75,1,33,18478,19516,56369,75885,46,61213
75,1,34,17250,19991,47847,67838,46,61206
75,1,35,17259,19033,48665,67698,46,61210
75,1,36,15632,20260,63155,83415,46,61241
75,1,37,16876,18585,61440,80025,46,61214
75,1,38,15697,21876,69998,91874,46,61234
75,1,39,14647,25698,56953,82651,46,61212
75,1,40,15213,23222,58702,81924,46,61235
75,1,41,14312,23346,61980,85326,46,61200
75,1,42,15198,24339,59051,83390,46,61240
75,1,43,14704,22548,59461,82009,46,61212
75,1,44,15237,21461,60692,82153,46,61235
75,1,45,15456,23276,56125,79401,46,61236
75,1,46,15558,22960,58705,81665,46,61233
75,1,47,14883,23395,59715,83110,46,61250
75,1,48,13719,23804,68288,92092,46,61210
75,1,49,13437,26800,61482,88282,46,61212
75,1,50,17125,24322,42875,67197,46,61207
76,1,1,13447,22398,66440,88838,45,59738
76,1,2,13246,23440,65190,88630,45,59743
76,1,3,13188,22935,66945,89880,45,59745
76,1,4,13861,23652,66038,89690,45,59734
76,1,5,13654,24586,72846,97432,45,59738
76,1,6,12470,27025,73731,100756,45,59762
76,1,7,10000,28049,76899,104948,45,59756
76,1,8,13080,27894,62551,90445,45,59748
76,1,9,14559,22919,67983,90902,45,59744
76,1,10,13846,23624,68559,92183,45,59735
76,1,11,13664,23943,67285,91228,45,59739
76,1,12,14025,23746,64718,88464,45,59731
76,1,13,13827,23619,68799,92418,45,59735
76,1,14,14168,23575,65946,89521,45,59731
76,1,15,13675,22656,84602,107258,45,59740
76,1,16,12217,28410,73224,101634,45,59766
76,1,17,13358,24440,68800,93240,45,59743
76,1,18,15266,23769,58136,81905,45,59773
76,1,19,16095,19708,55624,75332,45,59755
76,1,20,13832,21806,68917,90723,45,59735
76,1,21,14466,23471,53281,76752,45,59743
76,1,22,15160,20470,69269,89739,45,59773
76,1,23,13670,23884,65802,89686,45,59739
76,1,24,15060,19888,66990,86878,45,59776
76,1,25,13077,25196,64208,89404,45,59747
76,1,26,14353,22382,69287,91669,45,59747
76,1,27,13528,25193,63976,89169,45,59742
76,1,28,15846,20956,56901,77857,45,59760
76,1,29,14359,22871,66608,89479,45,59747
76,1,30,13592,24547,66742,91289,45,59740
76,1,31,13808,23960,67814,91774,45,59733
76,1,32,12759,27263,65781,93044,45,59753
76,1,33,10886,27212,89199,116411,45,59737
76,1,34,11496,26492,76229,102721,45,59743
76,1,35,13438,25324,66079,91403,45,59745
76,1,36,14678,22914,54119,77033,45,59740
76,1,37,13893,20419,72784,93203,45,59732
76,1,38,15918,19545,62803,82348,45,59758
76,1,39,12980,24016,68631,92647,45,59748
76,1,40,13806,22506,68314,90820,45,59734
76,1,41,13192,23738,66813,90551,45,59744
76,1,42,10000,25598,83761,109359,45,59755
76,1,43,12634,25476,61837,87313,45,59759
76,1,44,15592,19282,67083,86365,45,59763
76,1,45,12993,23554,70588,94142,45,59751
76,1,46,15740,23029,55184,78213,45,59761
76,1,47,14085,21873,69635,91508,45,59730
76,1,48,15906,20779,68973,89752,45,59761
76,1,49,13384,24091,69520,93611,45,59742
76,1,50,14070,24028,66508,90536,45,59729
77,1,1,5919,58574,174801,233375,47,85528
77,1,2,5842,63212,135938,199150,47,85528
77,1,3,9049,47018,150910,197928,47,85500
77,1,4,5781,57832,144802,202634,47,85536
77,1,5,10000,56656,150614,207270,47,85517
77,1,6,9885,47850,139964,187814,47,85527
77,1,7,6756,56787,138708,195495,47,85517
77,1,8,6975,57211,142838,200049,47,85511
77,1,9,5912,57833,147618,205451,47,85525
77,1,10,6620,57003,157710,214713,47,85504
77,1,11,7215,60790,161317,222107,47,85552
77,1,12,6225,58415,138541,196956,47,85516
77,1,13,6415,59715,140783,200498,47,85507
77,1,14,7437,56389,152610,208999,47,85534
77,1,15,7417,52086,147687,199773,47,85541
77,1,16,6976,49266,123851,173117,47,85520
77,1,17,7470,49632,145884,195516,47,85541
77,1,18,6976,53612,145612,199224,47,85513
77,1,19,7627,56295,140846,197141,47,85534
77,1,20,9090,58814,129843,188657,47,85501
77,1,21,8318,49690,150823,200513,47,85521
77,1,22,4387,68600,171271,239871,47,85533
77,1,23,4870,63297,144168,207465,47,85512
77,1,24,10000,49090,119586,168676,47,85518
77,1,25,9511,48362,134336,182698,47,85532
77,1,26,8797,55407,145656,201063,47,85507
77,1,27,8476,56556,142218,198774,47,85503
77,1,28,9711,57090,138110,195200,47,85522
77,1,29,6968,59700,140305,200005,47,85506
77,1,30,6990,49170,122587,171757,47,85510
77,1,31,5464,56909,162126,219035,47,85508
77,1,32,6601,60377,592620,652997,47,85510
77,1,33,5379,65843,165255,231098,47,85501
77,1,34,5932,61241,159000,220241,47,85520
77,1,35,5948,58156,228665,286821,47,85532
77,1,36,5920,51425,127390,178815,47,85530
77,1,37,7874,47454,144162,191616,47,85517
77,1,38,5956,55423,141728,197151,47,85524
77,1,39,7414,54086,145813,199899,47,85536
77,1,40,10000,52266,132511,184777,47,85516
77,1,41,5918,66407,158225,224632,47,85540
77,1,42,4928,61377,165834,227211,47,85514
77,1,43,9523,50803,169239,220042,47,85527
77,1,44,5419,61458,156349,217807,47,85504
77,1,45,6547,75038,154840,229878,47,85500
77,1,46,8811,56187,141627,197814,47,85512
77,1,47,10000,56821,125831,182652,47,85524
77,1,48,7694,48774,120982,169756,47,85524
77,1,49,7228,47279,143058,190337,47,85528
77,1,50,5688,61401,154297,215698,47,85541
78,1,1,10000,36988,65200,102188,45,59452
78,1,2,12622,31504,65841,97345,45,59457
78,1,3,12729,32325,65746,98071,45,59455
78,1,4,12807,32027,64662,96689,45,59453
78,1,5,10000,36311,74993,111304,45,59452
78,1,6,10000,36446,70638,107084,45,59451
78,1,7,12447,30996,78968,109964,45,59460
78,1,8,10000,36725,72732,109457,45,59452
78,1,9,10000,39402,78061,117463,45,59453
78,1,10,12055,35564,66892,102456,45,59468
78,1,11,10000,32128,69511,101639,45,59451
78,1,12,10470,37003,80013,117016,45,59440
78,1,13,10000,37966,75312,113278,45,59450
78,1,14,10000,36280,75528,111808,45,59451
78,1,15,10000,37536,71881,109417,45,59451
78,1,16,10000,37378,68324,105702,45,59452
78,1,17,10000,34579,79794,114373,45,59452
78,1,18,10000,38061,70303,108364,45,59451
78,1,19,10000,36650,85405,122055,45,59452
78,1,20,10000,38092,73276,111368,45,59452
78,1,21,10000,40630,68599,109229,45,59453
78,1,22,10000,33608,66477,100085,45,59451
78,1,23,11121,35734,79117,114851,45,59428
78,1,24,10000,35961,65191,101152,45,59452
78,1,25,12357,32223,65721,97944,45,59462
78,1,26,12442,31453,67249,98702,45,59462
78,1,27,12904,31672,63438,95110,45,59450
78,1,28,10000,40071,83795,123866,45,59452
78,1,29,10000,35576,72518,108094,45,59452
78,1,30,10000,36459,72473,108932,45,59452
78,1,31,10000,38117,73800,111917,45,59451
78,1,32,10000,42007,81133,123140,45,59454
78,1,33,10000,41624,74114,115738,45,59451
78,1,34,10000,36337,75436,111773,45,59453
78,1,35,10000,35950,72115,108065,45,59451
78,1,36,10980,37216,79448,116664,45,59430
78,1,37,10659,36038,78121,114159,45,59437
78,1,38,10000,37562,71657,109219,45,59452
78,1,39,10000,38883,75957,114840,45,59453
78,1,40,10000,35880,72173,108053,45,59452
78,1,41,10000,35322,74182,109504,45,59453
78,1,42,8840,36392,85034,121426,45,59442
78,1,43,10119,39353,77222,116575,45,59449
78,1,44,10000,36659,72736,109395,45,59453
78,1,45,10000,36213,72243,108456,45,59451
78,1,46,10000,37118,74468,111586,45,59452
78,1,47,10000,36644,71641,108285,45,59452
78,1,48,10000,37970,73520,111490,45,59453
78,1,49,10000,37565,75337,112902,45,59452
78,1,50,10000,35521,78775,114296,45,59453
79,1,1,8500,46836,90581,137417,44,47692
79,1,2,9530,44186,78325,122511,44,47727
79,1,3,10000,47627,104517,152144,44,47717
79,1,4,7530,57211,122070,179281,44,47722
79,1,5,8502,50126,95896,146022,44,47699
79,1,6,7660,49978,94197,144175,44,47718
79,1,7,7713,48171,97003,145174,44,47719
79,1,8,10000,48451,90598,139049,44,47717
79,1,9,10000,51722,101045,152767,44,47708
79,1,10,9892,58437,94335,152772,44,47721
79,1,11,10000,48350,82584,130934,44,47716
79,1,12,10000,41917,93283,135200,44,47720
79,1,13,10000,48326,99656,147982,44,47718
79,1,14,9902,52051,84992,137043,44,47718
79,1,15,10000,44083,81212,125295,44,47718
79,1,16,10000,43221,89858,133079,44,47711
79,1,17,10000,48102,86266,134368,44,47717
79,1,18,10000,41373,88720,130093,44,47709
79,1,19,10000,48565,94949,143514,44,47712
79,1,20,9099,47807,95450,143257,44,47708
79,1,21,10000,48985,87041,136026,44,47713
79,1,22,7693,47745,94808,142553,44,47724
79,1,23,10000,49071,87184,136255,44,47718
79,1,24,10000,42803,89315,132118,44,47709
79,1,25,7214,50558,119019,169577,44,47734
79,1,26,7484,57000,100257,157257,44,47722
79,1,27,10000,49876,90919,140795,44,47709
79,1,28,10000,47633,90283,137916,44,47707
79,1,29,8163,51222,92209,143431,44,47703
79,1,30,10000,46661,90154,136815,44,47717
79,1,31,9872,49311,96123,145434,44,47721
79,1,32,10000,47476,95818,143294,44,47716
79,1,33,8823,48685,82623,131308,44,47704
79,1,34,9399,41962,94578,136540,44,47731
79,1,35,10000,49950,81817,131767,44,47709
79,1,36,10000,45104,97996,143100,44,47716
79,1,37,10000,48599,80829,129428,44,47712
79,1,38,10000,41845,83459,125304,44,47718
79,1,39,7718,50410,110296,160706,44,47722
79,1,40,7988,50694,98983,149677,44,47706
79,1,41,10000,46352,76050,122402,44,47715
79,1,42,9558,42681,101494,144175,44,47723
79,1,43,10000,46904,77829,124733,44,47713
79,1,44,10000,41901,82468,124369,44,47713
79,1,45,10000,41832,88872,130704,44,47712
79,1,46,10000,42806,99615,142421,44,47716
79,1,47,10000,55863,88891,144754,44,47720
79,1,48,7387,46174,90110,136284,44,47731
79,1,49,9441,43561,86199,129760,44,47732
79,1,50,8240,50121,97501,147622,44,47702
80,1,1,7881,44245,131354,175599,47,87696
80,1,2,7950,45721,128736,174457,47,87690
80,1,3,5371,45193,145701,190894,47,87678
80,1,4,10000,45203,131241,176444,47,87687
80,1,5,8233,45514,145499,191013,47,87681
80,1,6,5696,47271,138209,185480,47,87709
80,1,7,6980,46101,139399,185500,47,87684
80,1,8,5842,45519,134678,180197,47,87702
80,1,9,7107,45471,131512,176983,47,87682
80,1,10,10000,45311,132284,177595,47,87687
80,1,11,10000,44270,126597,170867,47,87684
80,1,12,7448,46404,137142,183546,47,87709
80,1,13,6777,44387,148305,192692,47,87694
80,1,14,7730,46775,133445,180220,47,87696
80,1,15,7804,37625,122022,159647,47,87692
80,1,16,4809,54223,163099,217322,47,87699
80,1,17,6994,53666,128157,181823,47,87685
80,1,18,10000,39718,129850,169568,47,87691
80,1,19,8773,45770,131596,177366,47,87683
80,1,20,7220,44805,113667,158472,47,87721
80,1,21,10000,37961,127802,165763,47,87691
80,1,22,10000,47332,110651,157983,47,87696
80,1,23,10000,41344,134111,175455,47,87689
80,1,24,6337,45189,141528,186717,47,87685
80,1,25,5803,46853,141872,188725,47,87708
80,1,26,5947,49255,143115,192370,47,87697
80,1,27,5937,47798,145001,192799,47,87699
80,1,28,6463,46144,140045,186189,47,87673
80,1,29,6784,45898,140071,185969,47,87700
80,1,30,7694,45507,134560,180067,47,87694
80,1,31,6079,44558,131028,175586,47,87691
80,1,32,7953,44932,131005,175937,47,87691
80,1,33,7246,39235,147169,186404,47,87717
80,1,34,7438,45551,130419,175970,47,87707
80,1,35,5775,46232,147271,193503,47,87696
80,1,36,8445,38671,121451,160122,47,87669
80,1,37,9550,38649,128014,166663,47,87704
80,1,38,5868,51964,150236,202200,47,87702
80,1,39,6146,49789,145925,195714,47,87687
80,1,40,7706,43906,111879,155785,47,87684
80,1,41,5680,39757,143222,182979,47,87716
80,1,42,5816,45003,137279,182282,47,87710
80,1,43,6996,44628,126675,171303,47,87682
80,1,44,7482,39124,142668,181792,47,87702
80,1,45,10000,44763,131239,176002,47,87692
80,1,46,8772,44549,130137,174686,47,87683
80,1,47,6178,45735,136388,182123,47,87691
80,1,48,7696,45219,122333,167552,47,87693
80,1,49,7930,41469,142527,183996,47,87690
80,1,50,5689,45337,140414,185751,47,87711
81,1,1,10000,38009,120412,158421,52,108780
81,1,2,7449,38705,149730,188435,52,108797
81,1,3,5828,40070,159990,200060,52,108832
81,1,4,7050,45568,144553,190121,52,108793
81,1,5,7654,35715,130950,166665,52,108794
81,1,6,6369,40899,159351,200250,52,108779
81,1,7,5936,42236,134126,176362,52,108814
81,1,8,7017,37494,153400,190894,52,108812
81,1,9,7046,48661,170725,219386,52,108814
81,1,10,6106,42895,160858,203753,52,108823
81,1,11,6254,41136,151924,193060,52,108801
81,1,12,5833,40895,137614,178509,52,108837
81,1,13,10000,35563,138730,174293,52,108775
81,1,14,5685,41931,150264,192195,52,108820
81,1,15,7435,41033,148993,190026,52,108798
81,1,16,5763,41595,158276,199871,52,108810
81,1,17,7651,40265,149615,189880,52,108790
81,1,18,6952,35931,166860,202791,52,108793
81,1,19,5950,45169,147381,192550,52,108791
81,1,20,5804,35693,138657,174350,52,108815
81,1,21,5821,41067,156526,197593,52,108829
81,1,22,7952,41047,143968,185015,52,108785
81,1,23,5812,40617,168177,208794,52,108816
81,1,24,5793,39181,154051,193232,52,108814
81,1,25,10000,41022,134120,175142,52,108774
81,1,26,5677,35706,148912,184618,52,108820
81,1,27,8234,40818,150586,191404,52,108787
81,1,28,7459,42370,148006,190376,52,108809
81,1,29,5786,40714,149631,190345,52,108827
81,1,30,5943,37037,161747,198784,52,108821
81,1,31,5664,45259,687244,732503,52,108826
81,1,32,8178,43096,142610,185706,52,108780
81,1,33,5055,45804,154137,199941,52,108763
81,1,34,5952,34633,182931,217564,52,108791
81,1,35,9151,35352,145896,181248,52,108779
81,1,36,5924,39696,152648,192344,52,108784
81,1,37,5934,39399,152021,191420,52,108801
81,1,38,8233,38644,151913,190557,52,108774
81,1,39,5937,39643,165182,204825,52,108807
81,1,40,5902,40912,161974,202886,52,108799
81,1,41,6874,39809,152060,191869,52,108771
81,1,42,4209,43404,209262,252666,52,108793
81,1,43,8515,45860,227908,273768,52,108786
81,1,44,7568,45701,169394,215095,52,108819
81,1,45,4735,45655,175144,220799,52,108824
81,1,46,7448,41337,146528,187865,52,108823
81,1,47,6783,41560,145873,187433,52,108798
81,1,48,7971,37327,126501,163828,52,108806
81,1,49,7898,34987,134686,169673,52,108784
81,1,50,8212,38366,184302,222668,52,108818
82,1,1,9826,41167,92582,133749,45,67972
82,1,2,10000,41899,85053,126952,45,67958
82,1,3,10000,41663,79564,121227,45,67959
82,1,4,10000,36965,84721,121686,45,67965
82,1,5,8768,40691,93892,134583,45,67953
82,1,6,9904,42023,81358,123381,45,67966
82,1,7,10000,36089,78771,114860,45,67956
82,1,8,10000,40814,90230,131044,45,67964
82,1,9,8552,41849,87063,128912,45,67942
82,1,10,7900,44498,94394,138892,45,67957
82,1,11,9056,40630,84999,125629,45,67949
82,1,12,8850,36056,84688,120744,45,67951
82,1,13,10000,42115,91556,133671,45,67963
82,1,14,7393,42153,96222,138375,45,67975
82,1,15,10000,42766,88352,131118,45,67971
82,1,16,10000,43149,86894,130043,45,67964
82,1,17,8359,44256,93371,137627,45,67952
82,1,18,10000,35599,78547,114146,45,67954
82,1,19,9273,41251,97066,138317,45,67990
82,1,20,9145,42519,89529,132048,45,67944
82,1,21,7456,46565,109200,155765,45,67983
82,1,22,10000,48903,92059,140962,45,67968
82,1,23,8986,41482,93505,134987,45,67950
82,1,24,10000,41108,87337,128445,45,67961
82,1,25,8864,42325,93449,135774,45,67951
82,1,26,7684,41986,93360,135346,45,67968
82,1,27,10000,35588,75814,111402,45,67961
82,1,28,10000,41758,90022,131780,45,67955
82,1,29,10000,41393,104062,145455,45,67963
82,1,30,9175,35241,87643,122884,45,67942
82,1,31,10000,43704,91978,135682,45,67967
82,1,32,10000,36307,80245,116552,45,67966
82,1,33,9090,42054,95015,137069,45,67944
82,1,34,6973,59463,104618,164081,45,67954
82,1,35,7945,47389,98106,145495,45,67966
82,1,36,8958,43984,92273,136257,45,67951
82,1,37,10000,41840,86237,128077,45,67964
82,1,38,9396,41648,77837,119485,45,67978
82,1,39,10000,36650,77657,114307,45,67976
82,1,40,10000,36395,89022,125417,45,67955
82,1,41,9157,41535,117776,159311,45,67957
82,1,42,9396,45289,80727,126016,45,67983
82,1,43,10000,36103,79215,115318,45,67960
82,1,44,10000,37191,89100,126291,45,67954
82,1,45,8794,42002,96236,138238,45,67954
82,1,46,10000,35128,78285,113413,45,67959
82,1,47,10000,41464,87567,129031,45,67964
82,1,48,7675,43119,113016,156135,45,67964
82,1,49,8226,42446,86041,128487,45,67942
82,1,50,10000,42035,90216,132251,45,67958
83,1,1,4854,32323,198375,230698,44,49543
83,1,2,7878,32802,187476,220278,44,49552
83,1,3,5540,29085,198167,227252,44,49529
83,1,4,5148,28706,210257,238963,44,49545
83,1,5,7390,29752,185252,215004,44,49563
83,1,6,5906,28498,198239,226737,44,49560
83,1,7,5790,28432,196815,225247,44,49567
83,1,8,5821,29152,202512,231664,44,49558
83,1,9,7585,29201,197696,226897,44,49556
83,1,10,5361,29415,188077,217492,44,49539
83,1,11,5299,28420,205342,233762,44,49540
83,1,12,6702,29221,208293,237514,44,49550
83,1,13,5906,34319,233404,267723,44,49565
83,1,14,5386,34247,189101,223348,44,49539
83,1,15,6976,29075,171772,200847,44,49541
83,1,16,7442,24850,161135,185985,44,49558
83,1,17,5947,25024,185001,210025,44,49551
83,1,18,5160,31506,203285,234791,44,49546
83,1,19,5920,29643,189964,219607,44,49547
83,1,20,6768,25151,171184,196335,44,49547
83,1,21,7225,25026,166056,191082,44,49567
83,1,22,7927,25989,167353,193342,44,49541
83,1,23,5086,27387,199600,226987,44,49539
83,1,24,5962,33165,219905,253070,44,49551
83,1,25,5895,31894,198367,230261,44,49557
83,1,26,5908,29469,194434,223903,44,49557
83,1,27,5931,29300,194583,223883,44,49554
83,1,28,5911,29226,200695,229921,44,49559
83,1,29,5794,28759,196265,225024,44,49566
83,1,30,6667,26818,172391,199209,44,49547
83,1,31,8466,24927,165127,190054,44,49527
83,1,32,5913,25660,174170,199830,44,49550
83,1,33,6224,25376,194566,219942,44,49542
83,1,34,5910,29846,193909,223755,44,49547
83,1,35,5794,29267,201243,230510,44,49556
83,1,36,4546,34635,212647,247282,44,49543
83,1,37,5811,31706,203527,235233,44,49557
83,1,38,5331,28804,194164,222968,44,49532
83,1,39,5907,30092,189502,219594,44,49559
83,1,40,5367,29576,197740,227316,44,49544
83,1,41,6049,28241,188805,217046,44,49552
83,1,42,4496,29131,198578,227709,44,49552
83,1,43,6998,29620,191316,220936,44,49537
83,1,44,5910,28959,202512,231471,44,49555
83,1,45,5781,28855,183492,212347,44,49559
83,1,46,5797,26399,187673,214072,44,49568
83,1,47,5791,31192,202705,233897,44,49561
83,1,48,5980,25976,184837,210813,44,49548
83,1,49,5667,28121,205240,233361,44,49558
83,1,50,5900,28881,192183,221064,44,49554
84,1,1,19696,15732,37700,53432,44,58985
84,1,2,21026,15189,45507,60696,44,58967
84,1,3,20983,16806,42269,59075,44,58967
84,1,4,23838,16293,33008,49301,44,58998
84,1,5,19636,15753,53802,69555,44,58987
84,1,6,17836,20653,53645,74298,44,58949
84,1,7,19143,17189,43512,60701,44,58992
84,1,8,22155,16960,34084,51044,44,58954
84,1,9,23869,14300,35831,50131,44,58998
84,1,10,20745,16478,46150,62628,44,58971
84,1,11,21597,16522,47433,63955,44,58961
84,1,12,19743,18140,44633,62773,44,58983
84,1,13,19585,17949,46674,64623,44,58986
84,1,14,17731,20164,46616,66780,44,58951
84,1,15,19830,17779,43603,61382,44,58982
84,1,16,24226,13817,36299,50116,44,58994
84,1,17,23611,14990,36272,51262,44,59000
84,1,18,20306,15730,45819,61549,44,58976
84,1,19,19300,18117,42704,60821,44,58990
84,1,20,20102,17069,44651,61720,44,58979
84,1,21,19800,17648,45865,63513,44,58983
84,1,22,19860,18979,40885,59864,44,58982
84,1,23,22014,15947,44924,60871,44,58956
84,1,24,18318,20879,44711,65590,44,58942
84,1,25,19922,16657,42374,59031,44,58981
84,1,26,19767,16868,45279,62147,44,58984
84,1,27,19993,16850,43649,60499,44,58979
84,1,28,20103,16673,42235,58908,44,58979
84,1,29,18344,19543,45502,65045,44,58943
84,1,30,20190,16425,46695,63120,44,58978
84,1,31,18332,19437,48017,67454,44,58943
84,1,32,19148,17747,44315,62062,44,58993
84,1,33,20175,17019,39965,56984,44,58978
84,1,34,22310,14619,43163,57782,44,58953
84,1,35,19027,18660,45180,63840,44,58994
84,1,36,19863,18078,43039,61117,44,58982
84,1,37,18784,17806,41599,59405,44,58997
84,1,38,17436,19671,45128,64799,44,58954
84,1,39,19803,18322,44160,62482,44,58984
84,1,40,20992,16704,40014,56718,44,58969
84,1,41,19770,17347,50024,67371,44,58984
84,1,42,18915,19110,42613,61723,44,58995
84,1,43,18636,18277,41688,59965,44,58959
84,1,44,19761,18771,42606,61377,44,58984
84,1,45,19359,18223,43050,61273,44,58989
84,1,46,22928,14683,36049,50732,44,58947
84,1,47,19887,16853,43785,60638,44,58982
84,1,48,19526,18458,42001,60459,44,58987
84,1,49,24416,14080,40898,54978,44,58990
84,1,50,18453,17953,36774,54727,44,58962
85,1,1,6927,57221,137572,194793,46,67646
85,1,2,5592,59146,137996,197142,46,67648
85,1,3,10000,59294,107852,167146,46,67655
85,1,4,7407,52568,121775,174343,46,67691
85,1,5,5804,56978,121858,178836,46,67688
85,1,6,6369,54497,151185,205682,46,67683
85,1,7,6999,59752,140218,199970,46,67630
85,1,8,6228,59528,138395,197923,46,67675
85,1,9,5793,59813,142187,202000,46,67684
85,1,10,5812,64783,179387,244170,46,67689
85,1,11,5961,68151,178456,246607,46,67686
85,1,12,7425,54394,120523,174917,46,67670
85,1,13,7486,57344,135986,193330,46,67668
85,1,14,7456,51877,122536,174413,46,67688
85,1,15,6592,58283,141606,199889,46,67653
85,1,16,6452,62165,137217,199382,46,67639
85,1,17,9793,60447,133716,194163,46,67663
85,1,18,6435,59942,143942,203884,46,67661
85,1,19,6746,62849,138099,200948,46,67660
85,1,20,5794,64797,146740,211537,46,67682
85,1,21,6236,63175,144777,207952,46,67668
85,1,22,5781,60957,660430,721387,46,67674
85,1,23,4671,78482,158703,237185,46,67686
85,1,24,5527,64456,157098,221554,46,67653
85,1,25,4713,58081,202452,260533,46,67677
85,1,26,7862,57732,132362,190094,46,67653
85,1,27,7905,48457,114436,162893,46,67654
85,1,28,6240,54241,127667,181908,46,67665
85,1,29,7372,49534,128507,178041,46,67675
85,1,30,6122,67188,148481,215669,46,67666
85,1,31,5797,60990,133507,194497,46,67681
85,1,32,5949,59284,156405,215689,46,67649
85,1,33,5857,62823,157498,220321,46,67672
85,1,34,4782,91098,134201,225299,46,67641
85,1,35,5913,66454,190742,257196,46,67696
85,1,36,6285,51355,134424,185779,46,67655
85,1,37,7149,59178,139194,198372,46,67647
85,1,38,5941,60684,144133,204817,46,67686
85,1,39,5222,60092,148329,208421,46,67669
85,1,40,7188,62586,147823,210409,46,67706
85,1,41,7683,60167,167741,227908,46,67701
85,1,42,5940,58819,142678,201497,46,67673
85,1,43,7902,58479,117270,175749,46,67654
85,1,44,8194,51920,123109,175029,46,67641
85,1,45,6403,54588,136717,191305,46,67643
85,1,46,9426,55892,118260,174152,46,67688
85,1,47,10000,51941,128984,180925,46,67646
85,1,48,6594,60766,145066,205832,46,67671
85,1,49,5799,59615,142242,201857,46,67685
85,1,50,5652,67856,164299,232155,46,67704
86,1,1,10029,28830,114340,143170,47,65255
86,1,2,10000,34920,102670,137590,47,65256
86,1,3,8700,35253,91585,126838,47,65232
86,1,4,9961,30550,99571,130121,47,65251
86,1,5,10000,36432,91688,128120,47,65280
86,1,6,10000,30660,97503,128163,47,65256
86,1,7,9967,35308,105930,141238,47,65259
86,1,8,8738,35436,102915,138351,47,65265
86,1,9,9145,35605,127034,162639,47,65237
86,1,10,9843,39072,99821,138893,47,65264
86,1,11,10000,30814,88074,118888,47,65253
86,1,12,10000,34172,98563,132735,47,65270
86,1,13,7664,35219,102533,137752,47,65281
86,1,14,7666,34708,106548,141256,47,65262
86,1,15,9561,33436,87806,121242,47,65289
86,1,16,10000,29944,111139,141083,47,65259
86,1,17,10000,35077,87928,123005,47,65269
86,1,18,10000,30174,89304,119478,47,65260
86,1,19,9854,30043,114850,144893,47,65270
86,1,20,7440,41653,121613,163266,47,65281
86,1,21,10000,36168,89365,125533,47,65267
86,1,22,9146,34225,113179,147404,47,65260
86,1,23,8793,42136,93973,136109,47,65266
86,1,24,9435,31266,106411,137677,47,65268
86,1,25,8156,35206,108414,143620,47,65251
86,1,26,8792,33958,100754,134712,47,65232
86,1,27,10000,36587,99009,135596,47,65249
86,1,28,10000,34652,103782,138434,47,65265
86,1,29,10000,35181,105970,141151,47,65255
86,1,30,8630,38431,88753,127184,47,65241
86,1,31,10000,31953,102449,134402,47,65264
86,1,32,8815,36961,107870,144831,47,65249
86,1,33,10000,36521,103842,140363,47,65267
86,1,34,8455,35702,110908,146610,47,65234
86,1,35,9054,35539,101638,137177,47,65248
86,1,36,9871,32974,117741,150715,47,65265
86,1,37,9457,36092,101864,137956,47,65284
86,1,38,10000,35190,99647,134837,47,65260
86,1,39,8400,34301,103310,137611,47,65260
86,1,40,7890,35037,105299,140336,47,65263
86,1,41,10000,34899,98117,133016,47,65263
86,1,42,8815,30288,89859,120147,47,65265
86,1,43,10000,29996,92473,122469,47,65257
86,1,44,9939,33276,125883,159159,47,65278
86,1,45,10000,32287,96865,129152,47,65274
86,1,46,8646,35013,109848,144861,47,65233
86,1,47,8312,35756,109668,145424,47,65235
86,1,48,10000,34378,86516,120894,47,65260
86,1,49,9492,29341,88318,117659,47,65276
86,1,50,7669,33569,100371,133940,47,65270
87,1,1,20401,21894,38607,60501,43,42757
87,1,2,18972,23949,39780,63729,43,42775
87,1,3,17228,24143,44864,69007,43,42740
87,1,4,18386,24045,38972,63017,43,42726
87,1,5,22047,19439,41049,60488,43,42736
87,1,6,19735,22498,31146,53644,43,42764
87,1,7,22206,18919,38071,56990,43,42735
87,1,8,19393,22832,41528,64360,43,42769
87,1,9,20196,22324,39831,62155,43,42759
87,1,10,21210,23466,28454,51920,43,42746
87,1,11,21301,18476,40763,59239,43,42745
87,1,12,18771,22397,39301,61698,43,42780
87,1,13,21991,22531,31482,54013,43,42738
87,1,14,18376,21225,48390,69615,43,42725
87,1,15,18650,26010,35967,61977,43,42739
87,1,16,21592,22236,29967,52203,43,42741
87,1,17,21826,19212,33274,52486,43,42739
87,1,18,18901,22392,41031,63423,43,42778
87,1,19,22248,18197,35991,54188,43,42734
87,1,20,20198,22004,40152,62156,43,42760
87,1,21,19226,22558,38934,61492,43,42772
87,1,22,18517,22465,40292,62757,43,42742
87,1,23,19131,21990,37495,59485,43,42776
87,1,24,22015,21659,37365,59024,43,42737
87,1,25,19359,21856,39781,61637,43,42770
87,1,26,19131,22519,38043,60562,43,42772
87,1,27,19452,21947,39802,61749,43,42772
87,1,28,19816,20813,41265,62078,43,42764
87,1,29,18844,22380,38103,60483,43,42779
87,1,30,19749,21350,37188,58538,43,42766
87,1,31,19760,23835,38902,62737,43,42767
87,1,32,20037,20852,40601,61453,43,42761
87,1,33,17347,23154,46892,70046,43,42739
87,1,34,17962,24996,41207,66203,43,42728
87,1,35,22230,19879,38258,58137,43,42735
87,1,36,20006,22419,40120,62539,43,42762
87,1,37,22432,19544,31171,50715,43,42734
87,1,38,23042,17964,34656,52620,43,42726
87,1,39,19137,21507,40062,61569,43,42774
87,1,40,19532,22835,37984,60819,43,42768
87,1,41,18934,23179,39912,63091,43,42776
87,1,42,17716,22464,44255,66719,43,42734
87,1,43,21682,24212,27044,51256,43,42742
87,1,44,19399,20230,42909,63139,43,42770
87,1,45,18403,22593,40596,63189,43,42725
87,1,46,19539,22328,36569,58897,43,42768
87,1,47,19504,21094,39374,60468,43,42768
87,1,48,19201,21801,40615,62416,43,42773
87,1,49,19495,21816,35172,56988,43,42767
87,1,50,22994,19218,36411,55629,43,42725
88,1,1,18296,22275,56768,79043,44,52257
88,1,2,14913,25147,53608,78755,44,52310
88,1,3,16180,24043,53570,77613,44,52291
88,1,4,15830,23405,50139,73544,44,52296
88,1,5,16010,23595,51129,74724,44,52289
88,1,6,15639,23072,53498,76570,44,52301
88,1,7,15720,22259,54669,76928,44,52302
88,1,8,15606,23769,50020,73789,44,52301
88,1,9,15627,23514,49153,72667,44,52294
88,1,10,14948,23738,53789,77527,44,52311
88,1,11,17078,19936,54117,74053,44,52274
88,1,12,16035,23236,61194,84430,44,52295
88,1,13,18292,19916,48232,68148,44,52257
88,1,14,16143,23774,51075,74849,44,52286
88,1,15,16185,23060,46270,69330,44,52294
88,1,16,18648,20180,43356,63536,44,52273
88,1,17,16887,20578,53090,73668,44,52278
88,1,18,16261,24236,62110,86346,44,52288
88,1,19,15992,23529,57611,81140,44,52293
88,1,20,13964,27565,50809,78374,44,52269
88,1,21,17846,21899,49029,70928,44,52265
88,1,22,16159,23125,53531,76656,44,52285
88,1,23,16764,22599,40820,63419,44,52279
88,1,24,15508,21008,56153,77161,44,52300
88,1,25,16246,22361,51995,74356,44,52286
88,1,26,16542,23381,52673,76054,44,52284
88,1,27,16564,23580,53499,77079,44,52283
88,1,28,15894,24637,54485,79122,44,52293
88,1,29,15337,24593,51975,76568,44,52303
88,1,30,15506,22102,54929,77031,44,52295
88,1,31,16005,23674,49777,73451,44,52288
88,1,32,16561,23512,51536,75048,44,52286
88,1,33,16875,23205,57450,80655,44,52279
88,1,34,17293,23655,40937,64592,44,52271
88,1,35,16580,22735,51578,74313,44,52285
88,1,36,16178,23147,54039,77186,44,52291
88,1,37,17502,19106,60174,79280,44,52271
88,1,38,15813,26009,43219,69228,44,52293
88,1,39,17032,20019,52957,72976,44,52279
88,1,40,16476,25044,50026,75070,44,52282
88,1,41,16456,23692,51330,75022,44,52281
88,1,42,16364,23674,49918,73592,44,52289
88,1,43,16687,22599,52015,74614,44,52280
88,1,44,18549,19862,43314,63176,44,52271
88,1,45,18250,20945,43554,64499,44,52259
88,1,46,16822,22937,49580,72517,44,52283
88,1,47,17829,21492,45745,67237,44,52268
88,1,48,17137,19427,54298,73725,44,52274
88,1,49,16260,23376,50488,73864,44,52292
88,1,50,15446,22256,55510,77766,44,52300
89,1,1,10000,41216,96384,137600,43,43619
89,1,2,9794,48045,80594,128639,43,43629
89,1,3,10000,50684,94190,144874,43,43626
89,1,4,10000,48399,79821,128220,43,43619
89,1,5,10000,48049,80895,128944,43,43614
89,1,6,10000,48435,92774,141209,43,43618
89,1,7,10000,54339,91815,146154,43,43616
89,1,8,10000,46638,379194,425832,43,43615
89,1,9,8174,54326,87035,141361,43,43609
89,1,10,9482,47737,97809,145546,43,43635
89,1,11,10000,44231,102336,146567,43,43620
89,1,12,10000,47590,72795,120385,43,43614
89,1,13,10000,45512,77103,122615,43,43617
89,1,14,10000,44644,79952,124596,43,43616
89,1,15,9441,45912,86434,132346,43,43626
89,1,16,9231,48978,82293,131271,43,43640
89,1,17,10000,39451,67529,106980,43,43616
89,1,18,9189,41591,78689,120280,43,43594
89,1,19,10000,49959,90696,140655,43,43616
89,1,20,9950,57360,123555,180915,43,43624
89,1,21,10000,50947,77751,128698,43,43619
89,1,22,10000,52192,66991,119183,43,43617
89,1,23,9396,49415,83346,132761,43,43636
89,1,24,9823,48253,78648,126901,43,43630
89,1,25,10000,41546,67726,109272,43,43608
89,1,26,10000,43214,77293,120507,43,43615
89,1,27,10000,47799,74672,122471,43,43617
89,1,28,10000,50593,76143,126736,43,43610
89,1,29,10000,49196,81918,131114,43,43622
89,1,30,10792,41854,75602,117456,43,43603
89,1,31,10000,48606,76537,125143,43,43612
89,1,32,10000,49057,74698,123755,43,43615
89,1,33,10000,43311,76570,119881,43,43615
89,1,34,10000,47200,82135,129335,43,43624
89,1,35,10000,43517,70522,114039,43,43610
89,1,36,8182,46960,84002,130962,43,43610
89,1,37,10170,44398,77515,121913,43,43617
89,1,38,10000,44680,69564,114244,43,43618
89,1,39,10000,47134,94154,141288,43,43614
89,1,40,10000,47950,83722,131672,43,43620
89,1,41,7851,50609,88441,139050,43,43618
89,1,42,9295,47768,86520,134288,43,43639
89,1,43,10000,48105,75463,123568,43,43618
89,1,44,10000,47158,79856,127014,43,43617
89,1,45,8234,47915,81224,129139,43,43600
89,1,46,9196,50790,78174,128964,43,43591
89,1,47,9450,47700,83082,130782,43,43634
89,1,48,9416,50213,99426,149639,43,43633
89,1,49,10000,54776,85434,140210,43,43623
89,1,50,10000,48522,80310,128832,43,43618
90,1,1,17146,27397,53657,81054,43,42901
90,1,2,15496,27744,49167,76911,43,42927
90,1,3,15322,28197,48677,76874,43,42929
90,1,4,15786,27474,49489,76963,43,42922
90,1,5,14922,27428,51811,79239,43,42939
90,1,6,15955,26389,50073,76462,43,42919
90,1,7,14079,29097,52440,81537,43,42889
90,1,8,16360,27802,47252,75054,43,42912
90,1,9,16094,27236,54015,81251,43,42916
90,1,10,18427,23365,48218,71583,43,42886
90,1,11,15796,28097,48026,76123,43,42922
90,1,12,15109,29946,49955,79901,43,42934
90,1,13,16237,27454,48908,76362,43,42916
90,1,14,17886,26240,41744,67984,43,42891
90,1,15,16918,23461,41873,65334,43,42902
90,1,16,17394,23996,47235,71231,43,42897
90,1,17,16279,27436,45917,73353,43,42914
90,1,18,17650,23416,50833,74249,43,42892
90,1,19,15746,27719,49084,76803,43,42921
90,1,20,15498,27665,49554,77219,43,42927
90,1,21,15262,28617,48109,76726,43,42930
90,1,22,18271,22948,51686,74634,43,42887
90,1,23,16629,26774,45202,71976,43,42909
90,1,24,18199,26720,38755,65475,43,42887
90,1,25,15441,23853,60677,84530,43,42929
90,1,26,14421,29979,52267,82246,43,42906
90,1,27,15262,27886,49483,77369,43,42931
90,1,28,15613,27030,52130,79160,43,42925
90,1,29,13786,26471,54679,81150,43,42895
90,1,30,15736,28216,48598,76814,43,42924
90,1,31,15495,27680,50006,77686,43,42925
90,1,32,14724,29008,52624,81632,43,42899
90,1,33,16338,27540,49962,77502,43,42914
90,1,34,15814,28144,49886,78030,43,42921
90,1,35,16029,27214,61451,88665,43,42919
90,1,36,14539,32233,51791,84024,43,42901
90,1,37,15940,29014,50972,79986,43,42920
90,1,38,15243,28456,49017,77473,43,42930
90,1,39,15733,27660,48087,75747,43,42921
90,1,40,14647,28366,50127,78493,43,42900
90,1,41,14594,23524,47663,71187,43,42901
90,1,42,14926,27728,52622,80350,43,42937
90,1,43,15558,28607,48574,77181,43,42924
90,1,44,15169,28473,55343,83816,43,42932
90,1,45,15054,29703,50452,80155,43,42935
90,1,46,15220,28037,53776,81813,43,42932
90,1,47,15132,26428,52165,78593,43,42934
90,1,48,15790,28148,40466,68614,43,42921
90,1,49,16448,23908,56169,80077,43,42911
90,1,50,15660,28585,48116,76701,43,42923
91,1,1,26401,12473,27241,39714,43,42500
91,1,2,30994,15302,22125,37427,43,42520
91,1,3,32547,12361,23386,35747,43,42509
91,1,4,33519,14054,21199,35253,43,42501
91,1,5,30438,15736,23301,39037,43,42526
91,1,6,36901,11478,19692,31170,43,42477
91,1,7,36727,11271,24038,35309,43,42478
91,1,8,25950,18053,23035,41088,43,42505
91,1,9,35751,12909,18407,31316,43,42484
91,1,10,36439,11421,19416,30837,43,42479
91,1,11,31364,13276,23678,36954,43,42518
91,1,12,29250,13962,25383,39345,43,42476
91,1,13,26997,15418,26820,42238,43,42495
91,1,14,29187,13279,24378,37657,43,42475
91,1,15,32175,13241,24237,37478,43,42510
91,1,16,28167,14375,25720,40095,43,42484
91,1,17,31138,13825,24096,37921,43,42519
91,1,18,32324,13547,24479,38026,43,42510
91,1,19,29238,13631,24905,38536,43,42475
91,1,20,30512,14795,23774,38569,43,42525
91,1,21,30940,13618,24522,38140,43,42522
91,1,22,29278,16024,18754,34778,43,42476
91,1,23,31507,12609,24054,36663,43,42516
91,1,24,28147,15492,24112,39604,43,42484
91,1,25,31652,13728,24187,37915,43,42515
91,1,26,26479,15028,25920,40948,43,42500
91,1,27,29106,14225,24646,38871,43,42476
91,1,28,30882,13316,24612,37928,43,42522
91,1,29,30640,14659,23755,38414,43,42524
91,1,30,29242,15323,22900,38223,43,42476
91,1,31,35526,12280,23803,36083,43,42486
91,1,32,28646,13607,25891,39498,43,42481
91,1,33,29154,14460,24391,38851,43,42476
91,1,34,34005,11351,24598,35949,43,42496
91,1,35,31687,13599,23933,37532,43,42514
91,1,36,32049,13454,24297,37751,43,42512
91,1,37,30136,13375,25766,39141,43,42528
91,1,38,31261,15169,22430,37599,43,42518
91,1,39,34276,13500,19970,33470,43,42494
91,1,40,27776,13529,30390,43919,43,42488
91,1,41,30452,13351,25276,38627,43,42526
91,1,42,29222,13714,25606,39320,43,42476
91,1,43,29713,14982,23729,38711,43,42533
91,1,44,30662,13647,24369,38016,43,42523
91,1,45,27610,14633,24778,39411,43,42489
91,1,46,31333,13315,18891,32206,43,42517
91,1,47,32744,11710,24978,36688,43,42506
91,1,48,29889,14707,24245,38952,43,42531
91,1,49,29977,13741,23706,37447,43,42529
91,1,50,31662,13737,24108,37845,43,42515
92,1,1,12219,26699,69639,96338,46,66237
92,1,2,11503,29537,71969,101506,46,66211
92,1,3,13074,29681,58350,88031,46,66218
92,1,4,14028,24392,70695,95087,46,66199
92,1,5,11859,27366,58870,86236,46,66247
92,1,6,10978,25959,91407,117366,46,66202
92,1,7,13275,27569,68353,95922,46,66214
92,1,8,12372,28658,73908,102566,46,66232
92,1,9,12661,29151,66991,96142,46,66227
92,1,10,12252,28469,73110,101579,46,66236
92,1,11,14276,23857,59208,83065,46,66197
92,1,12,14227,24231,70743,94974,46,66199
92,1,13,12672,28401,69887,98288,46,66222
92,1,14,12472,28123,79080,107203,46,66228
92,1,15,10000,30998,71135,102133,46,66223
92,1,16,14892,23303,65963,89266,46,66245
92,1,17,12178,27565,72487,100052,46,66235
92,1,18,12262,27574,71378,98952,46,66235
92,1,19,12648,28013,73183,101196,46,66226
92,1,20,12571,28126,69945,98071,46,66227
92,1,21,12250,26846,84888,111734,46,66232
92,1,22,12370,28509,69738,98247,46,66231
92,1,23,13728,28677,56545,85222,46,66205
92,1,24,10000,25005,82056,107061,46,66228
92,1,25,11198,33652,77333,110985,46,66200
92,1,26,13072,29619,67601,97220,46,66214
92,1,27,12064,29486,71963,101449,46,66236
92,1,28,12916,28277,70989,99266,46,66223
92,1,29,12849,28928,71032,99960,46,66222
92,1,30,12780,28624,73094,101718,46,66227
92,1,31,12204,29757,72479,102236,46,66238
92,1,32,12744,29247,70184,99431,46,66227
92,1,33,12345,28979,73391,102370,46,66235
92,1,34,13737,26780,65097,91877,46,66206
92,1,35,12745,28325,70822,99147,46,66224
92,1,36,12667,29171,312345,341516,46,66227
92,1,37,12579,24831,62660,87491,46,66227
92,1,38,10000,32481,78286,110767,46,66220
92,1,39,10000,28471,83074,111545,46,66225
92,1,40,14272,23450,69110,92560,46,66197
92,1,41,12984,26272,68690,94962,46,66219
92,1,42,11296,29062,89362,118424,46,66220
92,1,43,9873,33239,76904,110143,46,66226
92,1,44,12723,27439,66875,94314,46,66224
92,1,45,13162,26446,76760,103206,46,66218
92,1,46,10000,32964,73638,106602,46,66224
92,1,47,10000,30113,79203,109316,46,66225
92,1,48,10102,38270,78427,116697,46,66223
92,1,49,10000,30707,76353,107060,46,66227
92,1,50,11584,37121,71242,108363,46,66208
93,1,1,35846,11379,22560,33939,43,42427
93,1,2,36488,11132,18817,29949,43,42423
93,1,3,38197,11359,18939,30298,43,42471
93,1,4,36997,11187,19444,30631,43,42420
93,1,5,41704,9153,19437,28590,43,42447
93,1,6,35506,11179,19474,30653,43,42429
93,1,7,23576,12638,40175,52813,43,42476
93,1,8,22792,17809,30370,48179,43,42423
93,1,9,28732,17175,19369,36544,43,42425
93,1,10,27417,11442,27912,39354,43,42436
93,1,11,26233,16082,23943,40025,43,42447
93,1,12,39807,12277,16130,28407,43,42460
93,1,13,39544,10382,19703,30085,43,42462
93,1,14,35772,11577,19148,30725,43,42427
93,1,15,36573,11609,34649,46258,43,42423
93,1,16,39482,10043,20683,30726,43,42462
93,1,17,32121,11096,24119,35215,43,42455
93,1,18,34942,11887,18498,30385,43,42434
93,1,19,34186,11512,45148,56660,43,42440
93,1,20,44110,9305,22437,31742,43,42434
93,1,21,22471,15145,35418,50563,43,42427
93,1,22,13760,24582,67294,91876,43,42427
93,1,23,8206,42075,106498,148573,43,42425
93,1,24,10000,38390,73294,111684,43,42440
93,1,25,10000,36849,83692,120541,43,42438
93,1,26,23389,58687,9146,67833,43,42417
93,1,27,22906,24570,36488,61058,43,42422
93,1,28,24219,19367,23117,42484,43,42468
93,1,29,28807,14351,25015,39366,43,42424
93,1,30,26780,18310,32637,50947,43,42441
93,1,31,26414,17687,21765,39452,43,42445
93,1,32,28032,15959,27443,43402,43,42431
93,1,33,23554,17404,36354,53758,43,42476
93,1,34,19178,17288,56860,74148,43,42467
93,1,35,22040,20346,27637,47983,43,42432
93,1,36,26074,18128,41701,59829,43,42449
93,1,37,18850,21780,52770,74550,43,42472
93,1,38,18927,18553,54598,73151,43,42471
93,1,39,32040,26147,19908,46055,43,42456
93,1,40,18867,24831,67635,92466,43,42471
93,1,41,22210,27009,27093,54102,43,42429
93,1,42,14432,18303,82133,100436,43,42436
93,1,43,15142,18314,60151,78465,43,42464
93,1,44,22130,34582,22504,57086,43,42430
93,1,45,31172,15041,27476,42517,43,42464
93,1,46,10000,27981,80024,108005,43,42440
93,1,47,28406,13562,52126,65688,43,42428
93,1,48,22424,16698,35822,52520,43,42427
93,1,49,12201,33502,76401,109903,43,42456
93,1,50,12838,33139,56311,89450,43,42444
94,1,1,6008,57700,123152,180852,44,45537
94,1,2,10000,48816,80209,129025,44,45535
94,1,3,10000,38717,88030,126747,44,45534
94,1,4,9261,47120,65978,113098,44,45553
94,1,5,10000,37698,75291,112989,44,45529
94,1,6,10000,36584,68892,105476,44,45524
94,1,7,9544,36126,76534,112660,44,45543
94,1,8,10000,42501,108446,150947,44,45536
94,1,9,10000,41523,83068,124591,44,45538
94,1,10,10000,37338,77312,114650,44,45541
94,1,11,10910,35217,74409,109626,44,45510
94,1,12,10000,37075,76664,113739,44,45538
94,1,13,9266,41204,98059,139263,44,45556
94,1,14,10000,39697,121703,161400,44,45536
94,1,15,6988,65995,101274,167269,44,45528
94,1,16,8114,53819,107798,161617,44,45527
94,1,17,10000,46887,122756,169643,44,45544
94,1,18,6735,43628,122283,165911,44,45532
94,1,19,8253,49597,115670,165267,44,45530
94,1,20,10000,45272,85669,130941,44,45534
94,1,21,7490,42496,102890,145386,44,45552
94,1,22,9475,49153,81765,130918,44,45545
94,1,23,10000,48012,97130,145142,44,45539
94,1,24,8749,49791,86854,136645,44,45532
94,1,25,7352,48271,93327,141598,44,45548
94,1,26,10000,51582,94194,145776,44,45538
94,1,27,9013,46868,109208,156076,44,45529
94,1,28,9572,46551,114117,160668,44,45550
94,1,29,8925,57845,203915,261760,44,45549
94,1,30,8862,61794,109355,171149,44,45538
94,1,31,5712,101255,190597,291852,44,45544
94,1,32,8270,86302,82229,168531,44,45522
94,1,33,8576,49732,175552,225284,44,45521
94,1,34,6123,93371,120041,213412,44,45535
94,1,35,9229,66824,112908,179732,44,45564
94,1,36,7796,76557,163066,239623,44,45541
94,1,37,7878,63272,112506,175778,44,45530
94,1,38,10000,44223,88474,132697,44,45539
94,1,39,7323,44366,122428,166794,44,45561
94,1,40,8026,47416,80547,127963,44,45530
94,1,41,7365,49737,98818,148555,44,45558
94,1,42,10000,44101,87218,131319,44,45538
94,1,43,8922,46156,93049,139205,44,45526
94,1,44,8432,47941,101912,149853,44,45516
94,1,45,7107,49142,105499,154641,44,45520
94,1,46,10000,45501,79421,124922,44,45538
94,1,47,8587,49012,111072,160084,44,45511
94,1,48,6824,73805,76096,149901,44,45527
94,1,49,7552,50575,90036,140611,44,45540
94,1,50,10000,42766,83412,126178,44,45535
95,1,1,3997,139176,216065,355241,44,55912
95,1,2,5216,116297,142853,259150,44,55917
95,1,3,6081,76729,148978,225707,44,55924
95,1,4,9232,71545,93256,164801,44,55943
95,1,5,7082,70924,166683,237607,44,55913
95,1,6,4702,124286,131751,256037,44,55933
95,1,7,7018,58977,183993,242970,44,55916
95,1,8,4839,93277,129268,222545,44,55913
95,1,9,8547,61901,164021,225922,44,55897
95,1,10,5884,82417,210642,293059,44,55934
95,1,11,7315,77245,153880,231125,44,55929
95,1,12,3873,105129,208905,314034,44,55929
95,1,13,4336,85735,191415,277150,44,55893
95,1,14,7400,80807,162488,243295,44,55938
95,1,15,5017,116221,160826,277047,44,55911
95,1,16,5934,107930,189732,297662,44,55929
95,1,17,5959,104606,139423,244029,44,55935
95,1,18,4791,133977,184379,318356,44,55918
95,1,19,3574,113239,222968,336207,44,55915
95,1,20,7776,76799,112762,189561,44,55917
95,1,21,7363,55384,117886,173270,44,55940
95,1,22,8744,55610,108113,163723,44,55910
95,1,23,6589,59260,143806,203066,44,55897
95,1,24,7286,86667,138536,225203,44,55939
95,1,25,6741,87238,151566,238804,44,55914
95,1,26,5364,85318,196339,281657,44,55929
95,1,27,5911,133208,199637,332845,44,55945
95,1,28,3694,163423,218054,381477,44,55943
95,1,29,3750,124006,190354,314360,44,55927
95,1,30,5790,113190,73027,186217,44,55927
95,1,31,9742,67610,112360,179970,44,55928
95,1,32,5614,84102,134263,218365,44,55907
95,1,33,6007,84682,173687,258369,44,55936
95,1,34,6012,108677,127680,236357,44,55928
95,1,35,7504,74910,126313,201223,44,55932
95,1,36,7498,64421,144837,209258,44,55926
95,1,37,4791,72247,207987,280234,44,55907
95,1,38,5973,101259,262419,363678,44,55946
95,1,39,6014,133076,229033,362109,44,55927
95,1,40,5893,110469,99301,209770,44,55933
95,1,41,3134,101422,381278,482700,44,55912
95,1,42,4800,183249,125560,308809,44,55905
95,1,43,5685,105775,207113,312888,44,55937
95,1,44,5452,141766,192224,333990,44,55913
95,1,45,5206,126403,179629,306032,44,55926
95,1,46,5571,107225,156161,263386,44,55897
95,1,47,4628,133820,146903,280723,44,55919
95,1,48,7700,71994,97942,169936,44,55926
95,1,49,7500,61725,119751,181476,44,55930
95,1,50,8550,57711,114041,171752,44,55898
96,1,1,3357,60380,247521,307901,46,63167
96,1,2,5389,62803,183757,246560,46,63131
96,1,3,4315,82548,236364,318912,46,63180
96,1,4,3328,106272,250678,356950,46,63205
96,1,5,6034,91615,283523,375138,46,63168
96,1,6,3033,141376,271120,412496,46,63159
96,1,7,2935,102682,370731,473413,46,63154
96,1,8,4285,111896,255504,367400,46,63146
96,1,9,4948,80742,168156,248898,46,63138
96,1,10,3424,81271,272714,353985,46,63184
96,1,11,4701,75194,200408,275602,46,63169
96,1,12,2958,73752,272981,346733,46,63154
96,1,13,3177,104244,307407,411651,46,63129
96,1,14,3021,77240,271613,348853,46,63161
96,1,15,3152,103049,273316,376365,46,63164
96,1,16,5191,74448,270978,345426,46,63168
96,1,17,3242,120403,205743,326146,46,63127
96,1,18,8156,45940,147922,193862,46,63157
96,1,19,6106,53751,169457,223208,46,63151
96,1,20,5992,52177,205902,258079,46,63159
96,1,21,4938,66683,185857,252540,46,63153
96,1,22,5773,75139,197998,273137,46,63181
96,1,23,3804,79917,197461,277378,46,63136
96,1,24,5286,56280,161201,217481,46,63174
96,1,25,6553,50772,142676,193448,46,63149
96,1,26,7196,48012,140402,188414,46,63180
96,1,27,6808,51451,178210,229661,46,63175
96,1,28,5932,55848,168100,223948,46,63168
96,1,29,4287,92940,220499,313439,46,63137
96,1,30,3722,64094,430835,494929,46,63171
96,1,31,3771,122572,202956,325528,46,63188
96,1,32,7467,66267,158572,224839,46,63161
96,1,33,4927,72842,238553,311395,46,63121
96,1,34,2299,148174,350981,499155,46,63130
96,1,35,3337,110115,260679,370794,46,63150
96,1,36,5865,75082,158592,233674,46,63166
96,1,37,4744,52584,159521,212105,46,63155
96,1,38,5076,62742,164086,226828,46,63139
96,1,39,7788,54665,145840,200505,46,63169
96,1,40,5314,59155,180024,239179,46,63147
96,1,41,2940,101822,262205,364027,46,63151
96,1,42,2925,138255,276328,414583,46,63152
96,1,43,5917,87518,222817,310335,46,63178
96,1,44,4414,59608,185740,245348,46,63162
96,1,45,3386,82448,284980,367428,46,63146
96,1,46,4437,102150,242674,344824,46,63173
96,1,47,5138,69567,241290,310857,46,63167
96,1,48,5917,62015,262507,324522,46,63202
96,1,49,5230,67876,240258,308134,46,63172
96,1,50,5932,77790,191086,268876,46,63177
97,1,1,12600,34167,59068,93235,43,42826
97,1,2,8972,50382,71623,122005,43,42812
97,1,3,10000,50264,60839,111103,43,42819
97,1,4,10000,34333,96621,130954,43,42819
97,1,5,10000,47835,102500,150335,43,42821
97,1,6,12066,38364,44771,83135,43,42836
97,1,7,8298,43886,93500,137386,43,42801
97,1,8,7378,77142,142424,219566,43,42836
97,1,9,5866,70916,129767,200683,43,42821
97,1,10,10000,34528,134496,169024,43,42822
97,1,11,10000,49972,61636,111608,43,42818
97,1,12,6044,59718,133800,193518,43,42820
97,1,13,12916,30453,70544,100997,43,42817
97,1,14,10656,41173,86577,127750,43,42804
97,1,15,15290,32984,49118,82102,43,42837
97,1,16,16446,29565,85944,115509,43,42821
97,1,17,7657,54993,96860,151853,43,42822
97,1,18,10000,33832,69916,103748,43,42820
97,1,19,10000,53781,57819,111600,43,42822
97,1,20,10000,41529,71440,112969,43,42818
97,1,21,11791,41609,68182,109791,43,42842
97,1,22,12536,39875,56718,96593,43,42826
97,1,23,10000,43858,65377,109235,43,42819
97,1,24,11834,45626,53275,98901,43,42841
97,1,25,10000,55311,92172,147483,43,42824
97,1,26,10000,56055,47204,103259,43,42820
97,1,27,10000,36026,70928,106954,43,42818
97,1,28,13326,44437,57557,101994,43,42808
97,1,29,12123,48250,48583,96833,43,42838
97,1,30,12306,32350,67509,99859,43,42833
97,1,31,13171,35756,53668,89424,43,42812
97,1,32,13298,35994,49071,85065,43,42811
97,1,33,12522,35977,62466,98443,43,42825
97,1,34,10000,38214,70614,108828,43,42816
97,1,35,10000,42357,67949,110306,43,42819
97,1,36,10150,43784,89418,133202,43,42818
97,1,37,12410,43685,44856,88541,43,42828
97,1,38,10000,39268,69565,108833,43,42815
97,1,39,10000,44883,67131,112014,43,42821
97,1,40,16204,28091,56315,84406,43,42820
97,1,41,12626,32061,82935,114996,43,42825
97,1,42,11760,36356,64612,100968,43,42803
97,1,43,15320,31804,46222,78026,43,42835
97,1,44,12121,30612,71906,102518,43,42835
97,1,45,14772,33687,44429,78116,43,42805
97,1,46,10000,32966,72684,105650,43,42816
97,1,47,10000,43990,58728,102718,43,42817
97,1,48,12816,48999,50455,99454,43,42820
97,1,49,12297,38003,58369,96372,43,42830
97,1,50,12223,36177,60477,96654,43,42829
98,1,1,861,51683,1930166,1981849,172,1137049
98,1,2,883,55742,1597145,1652887,172,1137039
98,1,3,457,66394,2381614,2448008,172,1137021
98,1,4,558,78249,2060757,2139006,172,1137001
98,1,5,885,59306,1633078,1692384,172,1137055
98,1,6,771,54912,1978329,2033241,172,1137006
98,1,7,1032,61720,1930880,1992600,172,1137119
98,1,8,1057,57149,1513438,1570587,172,1137076
98,1,9,739,59313,1933597,1992910,172,1137062
98,1,10,901,45908,1520088,1565996,172,1137098
98,1,11,841,44727,1661387,1706114,172,1137051
98,1,12,874,62568,1739486,1802054,172,1137124
98,1,13,584,60549,2245637,2306186,172,1137035
98,1,14,768,56241,2444658,2500899,172,1137049
98,1,15,410,149328,3198462,3347790,172,1136929
98,1,16,459,115327,2393911,2509238,172,1137017
98,1,17,1078,43283,2354811,2398094,172,1137134
98,1,18,726,55063,2465849,2520912,172,1137085
98,1,19,538,63119,1886916,1950035,172,1137061
98,1,20,735,66216,2023420,2089636,172,1137053
98,1,21,675,50074,1846155,1896229,172,1137054
98,1,22,675,65077,2628203,2693280,172,1137022
98,1,23,522,59662,3065029,3124691,172,1137005
98,1,24,472,108521,2486659,2595180,172,1137045
98,1,25,1156,43431,1296004,1339435,172,1137092
98,1,26,1366,40629,1614872,1655501,172,1137183
98,1,27,1108,50574,1231301,1281875,172,1137090
98,1,28,1255,39276,1227043,1266319,172,1137117
98,1,29,1204,36550,1332101,1368651,172,1137099
98,1,30,1263,35881,1502587,1538468,172,1137110
98,1,31,776,50775,1732079,1782854,172,1137067
98,1,32,714,74164,1544445,1618609,172,1137041
98,1,33,864,56876,1780278,1837154,172,1137061
98,1,34,832,62596,1579647,1642243,172,1137079
98,1,35,727,63577,2100199,2163776,172,1137063
98,1,36,726,56968,1713367,1770335,172,1137112
98,1,37,954,49399,1785904,1835303,172,1137097
98,1,38,1052,49167,1605807,1654974,172,1137114
98,1,39,684,65480,2535486,2600966,172,1137062
98,1,40,855,66580,1748222,1814802,172,1137063
98,1,41,632,57397,1982914,2040311,172,1137039
98,1,42,991,41323,1623258,1664581,172,1137081
98,1,43,1008,43776,1477757,1521533,172,1137090
98,1,44,559,57864,1823588,1881452,172,1137039
98,1,45,795,58605,1762816,1821421,172,1137107
98,1,46,944,44617,1509891,1554508,172,1137117
98,1,47,590,98257,1855800,1954057,172,1137073
98,1,48,687,51687,1534959,1586646,172,1137061
98,1,49,954,56205,2270660,2326865,172,1137111
98,1,50,921,47657,1464514,1512171,172,1137144
99,1,1,8690,63305,125604,188909,44,55161
99,1,2,6670,38703,121215,159918,44,55187
99,1,3,10000,33225,98845,132070,44,55172
99,1,4,10000,33941,94142,128083,44,55182
99,1,5,10000,46987,165135,212122,44,55189
99,1,6,9631,53164,149181,202345,44,55194
99,1,7,8970,39639,96129,135768,44,55166
99,1,8,7166,49681,210842,260523,44,55207
99,1,9,7870,43016,164201,207217,44,55180
99,1,10,10000,54629,160369,214998,44,55187
99,1,11,10000,41081,103400,144481,44,55178
99,1,12,10000,57025,92847,149872,44,55180
99,1,13,7099,43657,174699,218356,44,55177
99,1,14,10000,46920,82803,129723,44,55183
99,1,15,6009,40260,156835,197095,44,55177
99,1,16,10000,36976,141329,178305,44,55187
99,1,17,8824,37747,97579,135326,44,55167
99,1,18,10000,41561,109449,151010,44,55187
99,1,19,10000,33490,78774,112264,44,55172
99,1,20,10000,30522,93418,123940,44,55173
99,1,21,10000,30705,81428,112133,44,55171
99,1,22,9714,38283,91821,130104,44,55186
99,1,23,10000,33788,92275,126063,44,55175
99,1,24,10000,29784,94172,123956,44,55176
99,1,25,10000,37311,107798,145109,44,55190
99,1,26,5097,61404,158732,220136,44,55155
99,1,27,10000,38257,90461,128718,44,55186
99,1,28,8114,44090,136108,180198,44,55171
99,1,29,7465,56654,109309,165963,44,55204
99,1,30,8439,45945,98379,144324,44,55163
99,1,31,8266,38687,164534,203221,44,55174
99,1,32,8583,66355,112878,179233,44,55164
99,1,33,8636,35286,113931,149217,44,55154
99,1,34,7310,59481,96463,155944,44,55190
99,1,35,8390,44762,93561,138323,44,55156
99,1,36,10000,34330,93687,128017,44,55174
99,1,37,10000,39732,105513,145245,44,55177
99,1,38,7692,65865,121201,187066,44,55190
99,1,39,8866,39616,86830,126446,44,55166
99,1,40,7952,37175,116415,153590,44,55180
99,1,41,8590,36838,108332,145170,44,55154
99,1,42,10000,41871,131444,173315,44,55179
99,1,43,10000,30233,79399,109632,44,55172
99,1,44,8161,32985,100490,133475,44,55162
99,1,45,10000,33676,103369,137045,44,55182
99,1,46,10000,28289,76725,105014,44,55179
99,1,47,10000,30364,80605,110969,44,55176
99,1,48,10836,30488,113243,143731,44,55163
99,1,49,9062,41857,83678,125535,44,55161
99,1,50,10000,33701,95341,129042,44,55180
100,1,1,4659,52762,229407,282169,51,136919
100,1,2,5048,53108,229282,282390,51,136860
100,1,3,4719,55175,259547,314722,51,136903
100,1,4,3751,58974,382155,441129,51,136941
100,1,5,3493,88152,322794,410946,51,136919
100,1,6,4206,79154,268634,347788,51,136899
100,1,7,4297,82853,281390,364243,51,136872
100,1,8,3693,79266,380353,459619,51,136983
100,1,9,3061,87837,448626,536463,51,136900
100,1,10,3584,87880,266887,354767,51,136919
100,1,11,4017,55709,301225,356934,51,136907
100,1,12,3523,72775,258032,330807,51,136905
100,1,13,2262,64648,523593,588241,51,136941
100,1,14,2790,158551,259459,418010,51,136861
100,1,15,2918,135071,308561,443632,51,136882
100,1,16,3898,94551,304230,398781,51,136907
100,1,17,2918,104574,265763,370337,51,136876
100,1,18,3205,58762,353414,412176,51,136877
100,1,19,3980,67747,277281,345028,51,136873
100,1,20,4790,64769,310832,375601,51,136924
100,1,21,3289,80180,361061,441241,51,136881
100,1,22,2700,82398,331109,413507,51,136919
100,1,23,3530,61235,354420,415655,51,136894
100,1,24,2928,83048,331813,414861,51,136923
100,1,25,3288,100906,360256,461162,51,136878
100,1,26,3584,69974,234110,304084,51,136878
100,1,27,5496,50988,302923,353911,51,136894
100,1,28,3285,83784,258473,342257,51,136862
100,1,29,4734,49284,210875,260159,51,136869
100,1,30,4813,49743,214823,264566,51,136859
100,1,31,2968,70511,442902,513413,51,136931
100,1,32,2868,115732,344032,459764,51,136898
100,1,33,2886,111304,375863,487167,51,136908
100,1,34,3361,93551,229339,322890,51,136881
100,1,35,4081,62415,287145,349560,51,136904
100,1,36,4621,62907,336710,399617,51,136925
100,1,37,3338,82348,455156,537504,51,136917
100,1,38,2160,161768,324292,486060,51,136878
100,1,39,4413,61040,298752,359792,51,136934
100,1,40,3528,80523,259603,340126,51,136885
100,1,41,4315,64777,216843,281620,51,136893
100,1,42,4488,67846,277296,345142,51,136894
100,1,43,3274,81404,316471,397875,51,136864
100,1,44,4112,71346,251195,322541,51,136895
100,1,45,3699,73986,378031,452017,51,136935
100,1,46,3267,110052,331970,442022,51,136876
100,1,47,3356,61525,385883,447408,51,136933
100,1,48,3692,102177,339960,442137,51,136946
100,1,49,4201,67542,233446,300988,51,136881
100,1,50,3145,79349,354346,433695,51,136910
